Die Adresse des Kunden	((	Müşterinin Adresi	))
Der Name der Firma	((	Şirketin adı	))
Die Telefonnummer des Lieferanten	((	Tedarikçinin telefon numarası	))
Der Bericht des Praktikanten	((	Stajyerler Raporu	))
Die Entscheidung des Managers	((	Yöneticinin kararı	))
Das Büro des Chefs	((	Patronun ofisi	))
Die E-Mail des Kollegen	((	Meslektaşının e -postası	))
Die Rechnung des Unternehmens	((	Şirketin faturası	))
Der Vertrag des Arbeitnehmers	((	Çalışanın sözleşmesi	))
Das Gehalt des Angestellten	((	Çalışanın maaşı	))
Die Bestellung des Kunden	((	Müşterinin Siparişi	))
Das Produkt des Herstellers	((	Üreticinin ürünü	))
Die Rechte des Autors	((	Yazarın hakları	))
Die Website des Händlers	((	Bayinin web sitesi	))
Die Aufgaben der Sekretärin	((	Sekreterin Thasks	))
Der Erfolg des Teams	((	Takımın başarısı	))
Die Kritik des Experten	((	Uzmanın eleştirisi	))
Die Meinung des Mitarbeiters	((	Çalışanın görüşü	))
Die Verantwortung des Ingenieurs	((	Mühendisin sorumluluğu	))
Die Vorschläge der Beraterin	((	Danışmanın önerileri	))
Die Vorteile des Online-Handels	((	Çevrimiçi ticaretin avantajları	))
Die Strategie des Unternehmens	((	Şirketin stratejisi	))
Das Profil des Kandidaten	((	Adayın profili	))
Die Investitionen des Investors	((	Yatırımcının yatırımları	))
Die Sicherheit der Daten	((	Verilerin güvenliği	))
Der Umsatz des Geschäfts	((	İşletmenin cirosu	))
Die Partner des Projekts	((	Projenin ortakları	))
Die Konditionen des Vertrags	((	Sözleşmenin koşulları	))
Die Pflichten des Arbeitgebers	((	İşverenin görevleri	))
Die Ziele der Kampagne	((	Kampanyanın hedefleri	))
Die Anforderungen des Marktes	((	Piyasanın gereksinimleri	))
Die Entwicklung des Marktes	((	Piyasanın gelişimi	))
Die Funktion des Tools	((	Aracın işlevi	))
Die Rolle des Direktors	((	Yönetmenin rolü	))
Die Aufzeichnungen des Treffens	((	Toplantının kayıtları	))
Die Erwartungen des Kunden	((	Müşterinin Beklentileri	))
Die Qualifikationen des Bewerbers	((	Başvuranın nitelikleri	))
Die Methoden des Coaches	((	Antrenörlerin yöntemleri	))
Die Lösungen des Problems	((	Sorunun çözümleri	))
Die Ergebnisse der Umfrage	((	Anketin sonuçları	))
Die Kompetenzen des Leiters	((	Merdivenin yetkinlikleri	))
Die Perspektiven des Absolventen	((	Mezun beklentileri	))
Die Präsentation des Verkäufers	((	Satıcının sunumu	))
Der Ruf des Unternehmens	((	Şirketin itibarı	))
Die Philosophie der Firma	((	Şirketin felsefesi	))
Die Technologie des Produkts	((	Ürünün teknolojisi	))
Die Vision des Gründers	((	Kurucunun vizyonu	))
Die Kultur des Betriebs	((	Şirket kültürü	))
Der Schutz des Konsumenten	((	Tüketicinin korunması	))
Die Identität der Marke	((	Markanın kimliği	))
Die Konkurrenz des Geschäfts	((	İşletmenin rekabeti	))
Die Kritiken des Films	((	Filmin incelemeleri	))
Die Stärken des Konzepts	((	Kavramın güçlü yönleri	))
Die Fähigkeiten des Arbeiters	((	İşçinin becerileri	))
Die Zufriedenheit des Kunden	((	Müşterinin memnuniyeti	))
Die Details des Plans	((	Planın ayrıntıları	))
Die Beweise der Theorie	((	Teorinin kanıtı	))
Die Geschichte des Landes	((	Ülkenin tarihi	))
Die Herausforderungen des Jobs	((	İşin zorlukları	))
Die Angebote des Shops	((	Dükkanın teklifleri	))
Der Wert des Hauses	((	Evin değeri	))
Die Risiken der Investition	((	Yatırımın riskleri	))
Die Prinzipien der Organisation	((	Organizasyonun ilkeleri	))
Der Charakter des Kollegen	((	Meslektaşının karakteri	))
Die Nachteile der Technologie	((	Teknolojinin dezavantajları	))
Die Aktien des Unternehmens	((	Şirketin hisseleri	))
Die Gründe der Entscheidung	((	Kararın nedenleri	))
Die Merkmale des Produkts	((	Ürünün özellikleri	))
Die Dienstleistungen des Anbieters	((	Sağlayıcının hizmetleri	))
Die Mitglieder des Vereins	((	Dernek üyeleri	))
Die Grundsätze der Politik	((	Siyaset ilkeleri	))
Der Geschmack des Weins	((	Şarabın Tadı	))
Die Faktoren des Wachstums	((	Büyüme faktörleri	))
Die Preise des Anbieters	((	Sağlayıcının fiyatları	))
Die Eigenschaften des Materials	((	Malzemenin özellikleri	))
Die Alternativen der Lösung	((	Çözümün alternatifleri	))
Die Bedeutung des Wortes	((	Kelimenin anlamı	))
Die Fristen der Aufgabe	((	Görevin son tarihleri	))
Die Eigentümer der Immobilie	((	Mülkün sahipleri	))
Die Änderungen der Richtlinien	((	Yönergelerdeki değişiklikler	))
Die Sitzung des Vorstands	((	Kurul toplantısı	))
Die Qualität des Services	((	Hizmetin kalitesi	))
Der Zustand des Gebäudes	((	Binanın durumu	))
Die Botschaft des Textes	((	Metnin mesajı	))
Die Dynamik des Marktes	((	Pazarın dinamikleri	))
Die Fähigkeiten des Führers	((	Liderlerin Becerileri	))
Die Verbindungen des Computers	((	Bilgisayarın bağlantıları	))
Die Wirkung des Medikaments	((	İlacın etkisi	))
Die Kapazität des Akkus	((	Pilin kapasitesi	))
Die Struktur des Programms	((	Programın yapısı	))
Der Einfluss der Regierung	((	Hükümetin etkisi	))
Die Kapitel des Buches	((	Kitabın bölümleri	))
Der Umfang des Projekts	((	Projenin kapsamı	))
Die Ursachen des Problems	((	Sorunun nedenleri	))
Die Hauptstadt des Landes	((	Ülkenin başkenti	))
Die Resultate der Studie	((	Çalışmanın sonuçları	))
Die Farben des Regenbogens	((	Gökkuşağının renkleri	))
Die Vorteile des Systems	((	Sistemin avantajları	))
Die Wünsche des Kindes	((	Çocuğun istekleri	))
Die Traditionen des Volkes	((	Halkın Gelenekleri	))
Die Strategie des Marketings	((	Pazarlama stratejisi	))
Die Bilanz des Geschäftsjahres	((	Mali yılın bakiyesi	))
Der Jahresbericht des Unternehmens	((	Şirketin yıllık raporu	))
Die Kompetenz des Teams	((	Ekibin yetkinliği	))
Die Innovationskraft des Unternehmens	((	Şirketin yenilikçi gücü	))
Der Kundenservice des Anbieters	((	Sağlayıcının müşteri hizmetleri	))
Die Handelsbeziehungen des Landes	((	Ülkenin ticaret ilişkileri	))
Die Unternehmenskultur der Firma	((	Şirketin Kurum Kültürü	))
Die Vertriebsstrategie des Produkts	((	Ürünün satış stratejisi	))
Die Rendite des Investments	((	Yatırımın Geri Dönüşü	))
Die Verschwiegenheitspflicht des Angestellten	((	Çalışanın gizlilik yükümlülüğü	))
Die Leistungsindikatoren des Projekts	((	Projenin proje göstergeleri	))
Die Liquidität des Unternehmens	((	Şirketin likiditesi	))
Die Gehaltserhöhung des Mitarbeiters	((	Çalışanın maaş artışı	))
Die Marktpositionierung des Produkts	((	Ürünün pazar konumlandırılması	))
Die Geschäftsbeziehung des Partners	((	Ortağın iş ilişkisi	))
Die Wettbewerbsfähigkeit des Unternehmens	((	Şirketin rekabet gücü	))
Die Nachhaltigkeitsstrategie der Firma	((	Şirketin sürdürülebilirlik stratejisi	))
Die Kernkompetenzen der Organisation	((	Kuruluşun temel yeterlilikleri	))
Die Profitabilität des Geschäftsmodells	((	İş modelinin karlılığı	))
Die Adresse des Kunden	((	Müşterinin Adresi	))
Der Name des Lieferanten	((	Tedarikçinin adı	))
Die Rechnung des Verkäufers	((	Satıcının faturası	))
Die Produkte des Herstellers	((	Üreticinin ürünleri	))
Der Standort des Büros	((	Ofisin yeri	))
Die Größe des Unternehmens	((	Şirketin büyüklüğü	))
Der Preis des Artikels	((	Makalenin fiyatı	))
Die Anforderungen des Jobs	((	İşin gereksinimleri	))
Der Chef des Teams	((	Takımın Başkanı	))
Die Öffnungszeiten des Geschäfts	((	İşletmenin açılış saatleri	))
Der Rabatt des Verkäufers	((	Satıcının İndirimi	))
Die Lieferzeit des Produkts	((	Ürünün teslimat süresi	))
Die Qualität der Dienstleistung	((	Hizmetin kalitesi	))
Der Umsatz des Geschäfts	((	İşletmenin cirosu	))
Der Vertrag des Anbieters	((	Sağlayıcının sözleşmesi	))
Der Kunde des Beraters	((	Danışmanın müşterisi	))
Die Aufgaben des Managers	((	Yöneticinin görevleri	))
Die Verspätung des Fluges	((	Uçuşun gecikmesi	))
Die Ergebnisse des Meetings	((	Toplantının sonuçları	))
Der Vorteil des Angebots	((	Teklifin avantajı	))
Die Meinung des Kunden	((	Müşterinin görüşü	))
Die Strategie des Unternehmens	((	Şirketin stratejisi	))
Die Filiale des Banken	((	Bankaların Şubesi	))
Die Methoden der Forschung	((	Araştırma yöntemleri	))
Die Partner des Projekts	((	Projenin ortakları	))
Die Ziele des Workshops	((	Atölyenin hedefleri	))
Der Bonus des Mitarbeiters	((	Çalışanın bonusu	))
Die Politik des Unternehmens	((	Şirketin Politikası	))
Der Kredit des Kunden	((	Müşterinin kredisi	))
Die Dienstleistungen des Hotels	((	Otelin hizmetleri	))
Der Lohn des Arbeiters	((	İşçinin ücretleri	))
Die Beförderung des Angestellten	((	Çalışanın tanıtımı	))
Der Bericht des Praktikanten	((	Stajyerler Raporu	))
Die Erfahrungen des Praktikanten	((	Stajyerin deneyimi	))
Die Zahlungsmethoden des Shops	((	Mağazanın ödeme yöntemleri	))
Die Erwartungen des Investors	((	Yatırımcının beklentileri	))
Der Gewinn des Unternehmens	((	Şirketin karı	))
Die Schulungen des Personals	((	Personelin eğitimi	))
Die Rolle des Managers	((	Yöneticinin rolü	))
Die Entwicklungen des Marktes	((	Piyasanın gelişmeleri	))
Die Kontaktdaten des Lieferanten	((	Tedarikçinin iletişim bilgileri	))
Die Verantwortung des Managers	((	Yöneticinin sorumluluğu	))
Die Frist des Vertrags	((	Sözleşmenin son tarihi	))
Der Geschäftspartner des Unternehmens	((	Şirketin iş ortağı	))
Die Fähigkeiten des Bewerbers	((	Başvuranın becerileri	))
Die Vorgeschichte des Produkts	((	Ürünün tarihi	))
Der Beitrag des Mitarbeiters	((	Çalışanın katkısı	))
Die Zukunft des Unternehmens	((	Şirketin geleceği	))
Die Beurteilung des Praktikums	((	Stajın değerlendirilmesi	))
Die Bestellung des Kunden	((	Müşterinin Siparişi	))
Die Perspektiven des Markts	((	Piyasanın beklentileri	))
Die Referenzen des Beraters	((	Danışmanın referansları	))
Die Kritik des Vorgesetzten	((	Süpervizör eleştirisi	))
Die Technologie des Produkts	((	Ürünün teknolojisi	))
Die Risiken des Geschäfts	((	İşin riskleri	))
Die Informationen des Anbieters	((	Sağlayıcının bilgileri	))
Der Katalog des Händlers	((	Bayinin Kataloğu	))
Die Präsentation des Projekts	((	Projenin sunumu	))
Die Abteilung des Ingenieurs	((	Mühendis Departmanı	))
Die Produktlinie des Herstellers	((	Üreticinin ürün serisi	))
Der Rat des Kollegen	((	Meslektaşının tavsiyesi	))
Die Kennzahlen des Berichts	((	Raporun temel rakamları	))
Der Charakter des Unternehmens	((	Şirketin karakteri	))
Die Anerkennung des Chefs	((	Patronun tanınması	))
Die Aufstiegsmöglichkeiten des Jobs	((	İşin iş seçenekleri	))
Der Erfolg des Teams	((	Takımın başarısı	))
Die Herausforderungen des Marktes	((	Piyasanın zorlukları	))
Die Änderungen der Regeln	((	Kurallardaki değişiklikler	))
Die Stärken des Produkts	((	Ürünün güçlü yönleri	))
Die Zufriedenheit des Kunden	((	Müşterinin memnuniyeti	))
Die Auswirkungen der Entscheidung	((	Kararın etkileri	))
Die Schwächen des Plans	((	Planın zayıf yönleri	))
Der Geschmack des Weins	((	Şarabın Tadı	))
Der Vorschlag des Kollegen	((	Meslektaşının önerisi	))
Die E-Mail-Adresse des Kundendiensts	((	Müşteri Hizmetlerinin E -posta Adresi	))
Der Fortschritt des Projekts	((	Projenin ilerlemesi	))
Der Nutzen der Software	((	Yazılımın kullanımı	))
Die Investitionen des Unternehmens	((	Şirketin yatırımları	))
Die Bestimmungen des Vertrags	((	Sözleşmenin hükümleri	))
Der Abschluss des Geschäftsjahres	((	Mali yılın sonucu	))
Die Besprechung des Projekts	((	Projenin tartışılması	))
Die Sicherheit des Systems	((	Sistemin güvenliği	))
Die Erklärung des Professors	((	Profesörün Açıklaması	))
Der Fehler des Systems	((	Sistemin hatası	))
Die Anleitung des Geräts	((	Cihazın talimatları	))
Die Details des Plans	((	Planın ayrıntıları	))
Die Tätigkeiten des Unternehmens	((	Şirketin faaliyetleri	))
Der Beruf des Vaters	((	Baba mesleği	))
Die Menge der Ware	((	Mal miktarı	))
Die Ansicht des Kunden	((	Müşterinin görüşü	))
Der Inhalt des Buches	((	Kitabın içeriği	))
Die Schritte des Prozesses	((	Sürecin adımları	))
Die Merkmale des Produkts	((	Ürünün özellikleri	))
Die Fähigkeiten des Bewerbers	((	Başvuranın becerileri	))
Die Zuständigkeit des Managers	((	Yöneticinin sorumluluğu	))
Die Mitarbeiter des Monats	((	Ayın Çalışanları	))
Die Prinzipien des Unternehmens	((	Şirketin ilkeleri	))
Die Zeiten der Öffnungszeiten	((	Açılış saatleri	))
Die Alternativen des Projekts	((	Projenin alternatifleri	))
Der Vorteil des Angebots	((	Teklifin avantajı	))
Die Erwartungen des Chefs	((	Patronun beklentileri	))
Die Vorstellung des Produkts	((	Ürün fikri	))
Die Leistungen des Dienstleisters	((	Servis Sağlayıcının Hizmetleri	))
Der Bedarf des Marktes	((	Piyasanın ihtiyaçları	))
Der Ursprung des Problems	((	Sorunun kökeni	))
Die Frist des Projekts	((	Projenin son tarihi	))
Die Nachteile des Vorschlags	((	Teklifin dezavantajları	))
Die Vorteile der Methode	((	Yöntemin avantajları	))
Der Zweck der Studie	((	Çalışmanın amacı	))
Die Genehmigung des Antrags	((	Başvurunun onayı	))
Der Verlust des Unternehmens	((	Şirketin kaybı	))
Der Beitrag des Mitglieds	((	Üyenin katkısı	))
Die Bedingungen der Vereinbarung	((	Anlaşmanın koşulları	))
Die Motivation des Teams	((	Takımın motivasyonu	))
Die Eigenschaften des Materials	((	Malzemenin özellikleri	))
Der Inhaber des Patents	((	Patentin sahibi	))
Der Ursprung des Konflikts	((	Çatışmanın kökeni	))
Die Relevanz des Themas	((	Konunun ilgisi	))
Die Aktualität der Nachrichten	((	Haberlerin güncelliği	))
Die Ressourcen des Projekts	((	Projenin kaynakları	))
Die Lieferzeit des Produkts	((	Ürünün teslimat süresi	))
Der Standort des Büros	((	Ofisin yeri	))
Die Strategie des Unternehmens	((	Şirketin stratejisi	))
Die Qualität der Dienstleistung	((	Hizmetin kalitesi	))
Die Aufgaben des Praktikanten	((	Stajyerin görevleri	))
Die Größe des Teams	((	Takımın büyüklüğü	))
Der Ruf des Herstellers	((	Üreticinin çağrısı	))
Die Loyalität der Kunden	((	Müşterilerin Sadakati	))
Die Beschwerde des Klienten	((	Müşterinin şikayeti	))
Die Versprechen des Verkäufers	((	Satıcının Sözleri	))
Die Ansprüche der Stakeholder	((	Paydaşların iddiaları	))
Die Funktionen der Software	((	Yazılımın işlevleri	))
Die Vision des Gründers	((	Kurucunun vizyonu	))
Der Umsatz des Geschäfts	((	İşletmenin cirosu	))
Die Philosophie des Unternehmens	((	Şirketin felsefesi	))
Der Wert des Investments	((	Yatırımın değeri	))
Der Kunde des Monats	((	Ayın Müşterisi	))
Die Lösung des Problems	((	Sorunun çözümü	))
Die Produkte des Anbieters	((	Sağlayıcıların ürünleri	))
Die Erfolge des Teams	((	Takımın başarısı	))
Die Ziele des Projekts	((	Projenin hedefleri	))
Die Rolle des Direktors	((	Yönetmenin rolü	))
Der Gewinn des Unternehmens	((	Şirketin karı	))
Die Meinung des Kritikers	((	Eleştirmenin görüşü	))
Der Nutzen der Schulung	((	Eğitimin yararı	))
Die Ergebnisse der Umfrage	((	Anketin sonuçları	))
Der Grund des Ausfalls	((	Başarısızlığın nedeni	))
Die Empfehlungen des Beraters	((	Danışmanın önerileri	))
Die Entwicklung des Marktes	((	Piyasanın gelişimi	))
Die Forderungen der Arbeitnehmer	((	Çalışanların talepleri	))
Die Stärken des Bewerbers	((	Başvuranın güçlü yönleri	))
Der Kurs des Euro	((	Euro'nun seyri	))
Die Dienstleistungen des Unternehmens	((	Şirketin hizmetleri	))
Der Preis des Tickets	((	Biletin fiyatı	))
Die Geschichte des Staates	((	Devletin tarihi	))
Der Chef des Bereichs	((	Bölgenin başı	))
Die Anforderungen des Jobs	((	İşin gereksinimleri	))
Die Änderungen der Politik	((	Siyasetteki değişiklikler	))
Die Entscheidung des Gerichts	((	Mahkemenin kararı	))
Die Partner des Projekts	((	Projenin ortakları	))
Die Kultur des Unternehmens	((	Şirketin kültürü	))
Die Struktur des Programms	((	Programın yapısı	))
Der Einfluss des Wetters	((	Havanın etkisi	))
Der Wettbewerb des Marktes	((	Piyasanın rekabeti	))
Die Strategien des Managements	((	Yönetimin Stratejileri	))
Der Zugang zu den Informationen	((	Bilgilere erişim	))
Die Richtlinien der Organisation	((	Kuruluşun Yönergeleri	))
Die Rechte des Arbeitnehmers	((	Çalışanın hakları	))
Die Analyse des Spezialisten	((	Uzmanın analizi	))
Der Fokus des Treffens	((	Toplantının odak noktası	))
Die Probleme des Systems	((	Sistemin sorunları	))
Die Chancen des Marktes	((	Piyasanın fırsatları	))
Die Komponenten des Produkts	((	Ürünün bileşenleri	))
Der Schutz des Umwelts	((	Çevrenin korunması	))
Die Erwartungen des Investors	((	Yatırımcının beklentileri	))
Die Innovationen des Unternehmens	((	Şirketin yenilikleri	))
Die Beziehungen des Lieferanten	((	Tedarikçinin ilişkileri	))
Die Zertifizierungen des Produkts	((	Ürünün sertifikaları	))
Der Prozess des Lernens	((	Öğrenme süreci	))
Die Verantwortlichkeiten des Managers	((	Yöneticilerin sorumlulukları	))
Die Risiken des Vorhabens	((	Projenin riskleri	))
Der Status des Auftrags	((	Siparişin durumu	))
Die Technologien des Betriebs	((	Şirketin teknolojileri	))
Der Beitrag zur Konferenz	((	Konferansa katkı	))
Die Auswirkungen der Entscheidung	((	Kararın etkileri	))
Der Hauptsitz der Firma	((	Şirketin merkezi	))
Die Kriterien der Auswahl	((	Seçimin kriterleri	))
Der Zweck der Recherche	((	Araştırmanın amacı	))
Der Nutzer des Forums	((	Forum kullanıcısı	))
Die Methoden der Forschung	((	Araştırma yöntemleri	))
Die Stellungnahme des Experten	((	Uzmanın ifadesi	))
Die Schwächen des Plans	((	Planın zayıf yönleri	))
Die Konsequenzen der Handlungen	((	Eylemlerin sonuçları	))
Die Pflichten des Arbeitgebers	((	İşverenin görevleri	))
Der Gebrauch des Werkzeugs	((	Aracın kullanımı	))
Die Perspektiven des Marktes	((	Pazarın bakış açıları	))
Die Qualifikationen des Kandidaten	((	Adayların nitelikleri	))
Der Ursache des Problems	((	Sorunun nedeni	))
Der Charakter des Teams	((	Takımın karakteri	))
Die Einführung des Modells	((	Modelin tanıtımı	))
Die Vorteile des Systems	((	Sistemin avantajları	))
Die Funktion des Gerätes	((	Cihazın işlevi	))
Der Mangel an Informationen	((	Bilgi eksikliği	))
Die Effizienz der Methode	((	Yöntemin verimliliği	))
Die Prinzipien des Designs	((	Tasarım ilkeleri	))
Die Integrität der Daten	((	Verilerin bütünlüğü	))
Die Fähigkeiten des Roboters	((	Robotun yetenekleri	))
Der Ursprung des Wortes	((	Kelimenin kökeni	))
Die Verwendung der Technologie	((	Teknoloji kullanımı	))
Die Details des Vertrags	((	Sözleşmenin detayları	))
Die Eigenschaften der Lösung	((	Çözümün özellikleri	))
Der Geschmack des Weines	((	Şarabın Tadı	))
Die Flexibilität des Zeitplans	((	Programın esnekliği	))
Der Umfang des Projekts	((	Projenin kapsamı	))
Die Stabilität des Systems	((	Sistemin istikrarı	))
Die Theorien des Wissenschaftlers	((	Bilim İnsanı Teorileri	))
Die Präferenzen der Konsumenten	((	Tüketicilerin tercihleri	))
Die Ursachen des Phänomens	((	Fenomenin nedenleri	))
Der Bedarf an Spezialisten	((	Uzmanlara duyulan ihtiyaç	))
Die Anwendung des Gesetzes	((	Yasanın uygulanması	))
Die Bedeutung der Berufsorientierung	((	Profesyonel oryantasyonun önemi	))
Die Kriterien der Berufswahl	((	Kariyer Seçimi Kriterleri	))
Die Methoden der Berufsberatung	((	Kariyer danışmanlığı yöntemleri	))
Die Chancen der Weiterbildung	((	Daha fazla eğitim fırsatları	))
Die Herausforderungen des Berufseinstiegs	((	Kariyer girişinin zorlukları	))
Die Strategien der Berufsentwicklung	((	Mesleki gelişim stratejileri	))
Der Beginn der Berufslaufbahn	((	Profesyonel kariyerin başlangıcı	))
Die Aspekte der Berufszufriedenheit	((	Mesleki memnuniyetin yönleri	))
Der Zweck der Berufsplanung	((	Mesleki planlamanın amacı	))
Die Vorteile der Berufsausbildung	((	Mesleki eğitimin avantajları	))
Der Einfluss der Berufserfahrung	((	Mesleki deneyimin etkisi	))
Die Faktoren der Berufswahl	((	Kariyer seçiminin faktörleri	))
Die Dauer der Berufsausbildung	((	Mesleki eğitim süresi	))
Die Elemente der Berufsvorbereitung	((	Mesleki hazırlık unsurları	))
Die Schwierigkeiten des Berufswechsels	((	İş değiştirmenin zorlukları	))
Die Perspektiven des Berufsfeldes	((	Profesyonel alanın bakış açıları	))
Die Komponenten der Berufsqualifikation	((	Mesleki yeterliliğin bileşenleri	))
Die Rolle der Berufsorientierung	((	Profesyonel oryantasyonun rolü	))
Die Anforderungen des Berufslebens	((	Profesyonel yaşamın gereksinimleri	))
Der Nutzen der Berufsinformation	((	Profesyonel bilgilerin faydaları	))
Die Etappen der Berufskarriere	((	Profesyonel kariyerin aşamaları	))
Die Motivation zur Berufswahl	((	Bir kariyer seçme motivasyonu	))
Die Folgen der Berufsentscheidung	((	Mesleki kararın sonuçları	))
Der Ort der Berufsausbildung	((	Mesleki eğitimin yeri	))
Die Voraussetzungen für die Berufstätigkeit	((	Profesyonel faaliyet için önkoşullar	))
Die Kenntnisse im Berufsfeld	((	Profesyonel alanın bilgisi	))
Der Ablauf der Berufsorientierung	((	Profesyonel oryantasyonun seyri	))
Die Wirkung der Berufspraxis	((	Profesyonel uygulamanın etkisi	))
Die Prinzipien der Berufsethik	((	Mesleki etik ilkeleri	))
Die Methodik der Berufsförderung	((	Mesleki gelişim metodolojisi	))
Die Optionen im Berufsumfeld	((	Profesyonel ortamdaki seçenekler	))
Der Wert der Berufserfahrung	((	Mesleki deneyimin değeri	))
Die Alternativen zur Berufsorientierung	((	Kariyer yönelime alternatifler	))
Die Investition in die Berufsbildung	((	Mesleki eğitime yatırım	))
Die Kritik an der Berufsausbildung	((	Mesleki eğitimin eleştirisi	))
Der Bedarf an beruflichen Kompetenzen	((	Mesleki becerilere duyulan ihtiyaç	))
Die Präferenz für einen Berufszweig	((	Profesyonel bir şube tercihi	))
Der Vorteil einer Berufsspezialisierung	((	Profesyonel uzmanlaşmanın avantajı	))
Die Integration in den Berufsmarkt	((	Profesyonel pazara entegrasyon	))
Die Ausstattung des Arbeitsplatzes	((	İşyerinin ekipmanı	))
Die Struktur des Arbeitsumfeldes	((	Çalışma ortamının yapısı	))
Die Regeln der Arbeitswelt	((	İş dünyasının kuralları	))
Die Dynamik des Arbeitsmarktes	((	İşgücü piyasasının dinamikleri	))
Die Bedingungen des Arbeitplatzes	((	İşyerinin koşulları	))
Die Herausforderungen der Arbeitswelt	((	İş dünyasının zorlukları	))
Die Vorteile des Homeoffice	((	İçişleri Bakanlığı'nın avantajları	))
Der Lärm des Arbeitsplatzes	((	İşyerinin gürültüsü	))
Die Kultur der Arbeitsgemeinschaft	((	Çalışma grubunun kültürü	))
Die Veränderungen in der Arbeitswelt	((	İş dünyasındaki değişiklikler	))
Die Rolle der Arbeitsorganisation	((	İş organizasyonunun rolü	))
Die Zukunft der Arbeitswelt	((	İş dünyasının geleceği	))
Der Druck des Arbeitslebens	((	Çalışma hayatının baskısı	))
Die Verantwortung des Arbeitgebers	((	İşverenin sorumluluğu	))
Die Sicherheit am Arbeitsplatz	((	İşyerindeki güvenlik	))
Die Anforderungen des Arbeitsalltags	((	Günlük işin gereksinimleri	))
Der Einfluss der Arbeitsbedingungen	((	Çalışma koşullarının etkisi	))
Die Perspektiven des Arbeitsfeldes	((	İş alanının bakış açıları	))
Der Beitrag der Arbeitnehmer	((	Çalışanların katkısı	))
Die Ethik der Arbeitswelt	((	İş dünyasının etiği	))
Der Schutz der Arbeitsumgebung	((	Çalışma ortamının korunması	))
Die Aufgaben des Arbeitnehmers	((	Çalışanın görevleri	))
Der Wert der Arbeitsethik	((	İş ahlakının değeri	))
Die Kriterien für die Arbeitszufriedenheit	((	İş tatmini kriterleri	))
Die Fähigkeiten des Arbeitsteams	((	İş ekibinin becerileri	))
Die Politik des Unternehmens	((	Şirketin Politikası	))
Der Fokus der Arbeitsstrategie	((	Çalışma stratejisinin odağı	))
Die Qualität der Arbeitsergebnisse	((	İş sonuçlarının kalitesi	))
Der Vorteil flexibler Arbeitszeiten	((	Esnek çalışma saatlerinin avantajı	))
Die Risiken der Arbeitsbedingungen	((	Çalışma koşullarının riskleri	))
Die Zufriedenheit am Arbeitsplatz	((	İşyerindeki memnuniyet	))
Die Merkmale einer erfolgreichen Arbeitskultur	((	Başarılı bir çalışma kültürünün özellikleri	))
Die Komplexität der Arbeitswelt	((	İş dünyasının karmaşıklığı	))
Die Prinzipien des Arbeitsrechts	((	İş hukuku ilkeleri	))
Die Innovationskraft des Arbeitsplatzes	((	İşyerinin yenilikçi gücü	))
Die Auswirkungen der Arbeitssicherheit	((	İş güvenliğinin etkileri	))
Die Barrieren in der Arbeitswelt	((	İş dünyasındaki engeller	))
Der Umgang mit Stress am Arbeitsplatz	((	İşyerinde stresle uğraşmak	))
Die Erwartungen an die Arbeitnehmer	((	Çalışanların Beklentileri	))
Die Struktur des Bewerbungsschreibens	((	Başvuru mektubunun yapısı	))
Die Anforderungen des Bewerbungsprozesses	((	Başvuru sürecinin gereksinimleri	))
Die Rolle des Bewerbungsgesprächs	((	Röportajın rolü	))
Der Inhalt des Lebenslaufs	((	Müfredatın içeriği	))
Die Relevanz des Motivationsschreibens	((	Motivasyon mektubunun alaka düzeyi	))
Die Kriterien der Stellenausschreibung	((	İş reklamının kriterleri	))
Der Zweck des Anschreibens	((	Kapak mektubunun amacı	))
Die Dauer des Bewerbungsprozesses	((	Başvuru sürecinin süresi	))
Die Formalitäten der Bewerbung	((	Uygulamanın formaliteleri	))
Die Vorbereitung auf das Vorstellungsgespräch	((	Röportaj için hazırlık	))
Die Rückmeldung des Arbeitgebers	((	İşverenden gelen geri bildirim	))
Der Ablauf des Auswahlverfahrens	((	Seçim sürecinin süreci	))
Die Erfahrung des Bewerbers	((	Başvuranın deneyimi	))
Die Qualität der Bewerbungsunterlagen	((	Uygulama belgelerinin kalitesi	))
Der Eindruck im Bewerbungsgespräch	((	Röportajdaki izlenim	))
Die Entscheidung des Personalers	((	Personelin kararı	))
Die Bedeutung der Referenzen	((	Referansların önemi	))
Die Perspektive des Bewerbers	((	Başvuranın bakış açısı	))
Die Schwierigkeiten des Bewerbungsprozesses	((	Başvuru sürecinin zorlukları	))
Die Aufgaben des neuen Jobs	((	Yeni işin görevleri	))
Die Erwartungen des Arbeitgebers	((	İşverenin beklentileri	))
Der Beginn der Arbeitsstelle	((	İşin başlangıcı	))
Die Anforderungen des Arbeitsplatzes	((	İşyerinin gereksinimleri	))
Die Kollegen der Abteilung	((	Bölümdeki meslektaşlar	))
Die Herausforderungen des Berufs	((	Mesleğin zorlukları	))
Der Verdienst der Position	((	Pozisyonun değeri	))
Die Perspektiven der Karriere	((	Kariyerin bakış açıları	))
Die Regeln des Unternehmens	((	Şirketin kuralları	))
Der Alltag am Arbeitsplatz	((	İşyerinde Günlük Yaşam	))
Die Verantwortlichkeiten der Rolle	((	Rolün sorumlulukları	))
Die Möglichkeiten zur Weiterbildung	((	Daha fazla eğitim fırsatları	))
Der Beitrag zum Teamerfolg	((	Takım başarısına katkı	))
Die Schwierigkeiten im Umgang mit Kollegen	((	Meslektaşlarıyla uğraşmada zorluklar	))
Die Vorteile der Anstellung	((	İstihdamın avantajları	))
Die Kultur des Arbeitsumfelds	((	Çalışma ortamının kültürü	))
Die Entwicklungsmöglichkeiten im Unternehmen	((	Şirketteki geliştirme fırsatları	))
Der Konflikt am Arbeitsplatz	((	İşyerinde çatışma	))
Die Balance zwischen Arbeit und Freizeit	((	İş ve boş zaman arasındaki denge	))
Die Beförderungschancen in der Firma	((	Şirkette tanıtım fırsatları	))
Die Motivation des Teams	((	Takımın motivasyonu	))
Der Stressfaktor der Aufgabe	((	Görevin stres faktörü	))
Die Feedbackkultur im Unternehmen	((	Şirketteki geri bildirim kültürü	))
Der Nutzen der Zusatzleistungen	((	Ek hizmetlerin faydaları	))
Die Erfolge des Projektes	((	Projenin başarısı	))
Die Auswirkungen der Überstunden	((	Fazla mesai etkileri	))
Der Respekt unter den Kollegen	((	Meslektaşları arasındaki saygı	))
Die Flexibilität der Arbeitszeiten	((	Çalışma saatlerinin esnekliği	))
Der Beitrag zur Unternehmenskultur	((	Kurum kültürüne katkı	))
Die Wirkung der Führungskraft	((	Yöneticinin etkisi	))
Die Qualität der Arbeit	((	İşin kalitesi	))
Die Sicherheit am Arbeitsplatz	((	İşyerindeki güvenlik	))
Der Umgang mit der Technologie	((	Teknoloji ile uğraşmak	))
Die Beziehungen innerhalb des Teams	((	Ekip içindeki ilişkiler	))
Die Ziele des Unternehmens	((	Şirketin hedefleri	))
Der Einfluss der Arbeit auf das Privatleben	((	İşin özel hayat üzerindeki etkisi	))
Die Fortschritte in der Position	((	Pozisyondaki ilerleme	))
Die Unterstützung durch Vorgesetzte	((	Üstlerin desteği	))
Der Ablauf des Arbeitstages	((	İş gününün seyri	))
Die Herausforderungen der Aufgaben	((	Görevlerin zorlukları	))
Der Druck des Chefs	((	Patronun baskısı	))
Die Beziehung der Kollegen	((	Meslektaşları arasındaki ilişki	))
Der Stress des Projekts	((	Projenin stresi	))
Die Anforderungen der Kunden	((	Müşterilerin Gereksinimleri	))
Der Umgang mit der Technologie	((	Teknoloji ile uğraşmak	))
Die Lösung der Probleme	((	Sorunların çözümü	))
Die Wirkung der Pausen	((	Molaların etkisi	))
Die Bedeutung der Kommunikation	((	İletişimin önemi	))
Der Wert der Teamarbeit	((	Ekip çalışmasının değeri	))
Die Qualität der Produkte	((	Ürünlerin kalitesi	))
Der Beitrag zur Firmenkultur	((	Şirket kültürüne katkı	))
Die Verbesserung der Prozesse	((	Süreçlerin iyileştirilmesi	))
Die Erwartungen der Vorgesetzten	((	Üstlerin beklentileri	))
Die Details des Berichts	((	Raporun ayrıntıları	))
Die Entwicklung der Fähigkeiten	((	Becerilerin geliştirilmesi	))
Der Fokus der Besprechungen	((	Toplantıların odağı	))
Die Motivation der Mitarbeiter	((	Çalışanların motivasyonu	))
Die Besprechung der Projekte	((	Projelerin tartışılması	))
Die Anpassung an die Arbeitszeiten	((	Çalışma saatlerine uyum	))
Der Einfluss der Unternehmenspolitik	((	Kurumsal politikanın etkisi	))
Die Relevanz der Fortbildungen	((	Gelişmiş eğitimin alaka düzeyi	))
Die Verantwortlichkeit für die Fehler	((	Hataların sorumluluğu	))
Die Vorbereitung der Präsentationen	((	Sunumların hazırlanması	))
Die Organisation des Arbeitsbereichs	((	Çalışma alanının organizasyonu	))
Die Steigerung der Produktivität	((	Verimlilikteki artış	))
Die Wahrung der Qualitätsstandards	((	Kalite standartlarının korunması	))
Der Respekt vor den Hierarchien	((	Hiyerarşilere saygı	))
Die Priorisierung der Aufgaben	((	Görevlerin önceliklendirilmesi	))
Der Umgang mit der Kritik	((	Eleştiriyle uğraşmak	))
Die Integration neuer Mitarbeiter	((	Yeni çalışanların entegrasyonu	))
Die Pflege der Firmenwerte	((	Şirket değerlerinin bakımı	))
Die Koordination der Teams	((	Takımların koordinasyonu	))
Die Innovationen in der Branche	((	Sektördeki yenilikler	))
Die Lösung der Kundenprobleme	((	Müşteri sorunlarının çözümü	))
Der Schutz der Mitarbeiterdaten	((	Çalışan verilerinin korunması	))
Die Optimierung der Prozesse	((	Süreçlerin optimizasyonu	))
Die Analyse der Arbeitsabläufe	((	İş süreçlerinin analizi	))
Die Effizienz der Methoden	((	Yöntemlerin verimliliği	))
Die Planung der Projekte	((	Projelerin planlanması	))
Die Automatisierung der Aufgaben	((	Görevlerin otomasyonu	))
Der Rhythmus der Tätigkeiten	((	Faaliyetlerin ritmi	))
Die Qualität der Ergebnisse	((	Sonuçların kalitesi	))
Die Kontrolle der Vorgänge	((	Süreçlerin kontrolü	))
Der Ablauf der Besprechungen	((	Toplantıların seyri	))
Die Geschwindigkeit der Umsetzung	((	Uygulama hızı	))
Die Koordination der Teams	((	Takımların koordinasyonu	))
Die Flexibilität der Strukturen	((	Yapıların esnekliği	))
Die Verbesserung der Arbeitsabläufe	((	İş süreçlerinin iyileştirilmesi	))
Die Änderung der Strategien	((	Stratejilerin Değişimi	))
Die Präzision der Arbeitsschritte	((	İş adımlarının hassasiyeti	))
Der Fokus der Anstrengungen	((	Çabanın odağı	))
Die Praktiken der Problembehebung	((	Sorun sağlama uygulamaları	))
Die Interaktion der Abteilungen	((	Departmanların etkileşimi	))
Der Zyklus der Produktentwicklung	((	Ürün geliştirme döngüsü	))
Die Bewertung der Performance	((	Performansın değerlendirilmesi	))
Die Strukturierung der Informationen	((	Bilgilerin yapılandırılması	))
Die Integration der Systeme	((	Sistemlerin entegrasyonu	))
Die Verteilung der Ressourcen	((	Kaynakların dağılımı	))
Die Stabilität der Technologie	((	Teknolojinin istikrarı	))
Der Wandel der Organisationsstruktur	((	Organizasyon yapısındaki değişiklik	))
Die Standardisierung der Prozesse	((	Süreçlerin standardizasyonu	))
Die Dokumentation der Veränderungen	((	Değişikliklerin belgeleri	))
Die Anpassung der Richtlinien	((	Yönergelerin uyarlanması	))
Die Überprüfung der Qualität	((	Kalitenin gözden geçirilmesi	))
Die Definition der Ziele	((	Hedeflerin tanımı	))
Die Anforderungen an die Lieferanten	((	Tedarikçiler için gereksinimler	))
Die Verwaltung der Datenbanken	((	Veritabanlarının yönetimi	))
Der Austausch von Informationen	((	Bilgi alışverişi	))
Die Umsetzung der Neuerungen	((	Yeniliklerin uygulanması	))
Die Messung der Effektivität	((	Etkililiğin ölçümü	))
Die Spezifikation der Aufgaben	((	Görevlerin spesifikasyonu	))
Die Protokollierung der Meetings	((	Toplantıların kaydı	))
Die Reduzierung der Kosten	((	Maliyetlerin azaltılması	))
Die Kontrolle der Qualität	((	Kalitenin kontrolü	))
Der Standard des Produkts	((	Ürünün standardı	))
Das Ziel der Qualitätssicherung	((	Kalite güvencesinin amacı	))
Der Test des Prototyps	((	Prototip testi	))
Die Revision der Dokumente	((	Belgelerin revizyonu	))
Die Zertifizierung des Prozesses	((	Sürecin sertifikası	))
Das Audit des Systems	((	Sistemin denetimi	))
Die Anforderung an die Lieferanten	((	Tedarikçilere gereklilik	))
Das Feedback des Kunden	((	Müşterinin geri bildirimi	))
Der Bericht der Inspektion	((	İncelemenin raporu	))
Die Verbesserung der Methoden	((	Yöntemlerin iyileştirilmesi	))
Der Fehler im Produkt	((	Üründeki hata	))
Die Messung der Zufriedenheit	((	Memnuniyetin ölçümü	))
Die Validierung der Daten	((	Verilerin doğrulanması	))
Der Prozess des Managements	((	Yönetim süreci	))
Das Kriterium für den Erfolg	((	Başarı kriteri	))
Der Verantwortliche für die Qualität	((	Kaliteden sorumlu kişi	))
Die Überprüfung der Resultate	((	Sonuçların gözden geçirilmesi	))
Die Vorgabe für die Produktion	((	Üretim gereksinimi	))
Die Norm für die Sicherheit	((	Güvenlik Standardı	))
Die Einhaltung der Vorschriften	((	Düzenlemelere Uyum	))
Die Durchführung des Audits	((	Denetimin uygulanması	))
Der Ausschluss der Fehlerquelle	((	Hata kaynağının hariç tutulması	))
Die Dokumentation der Vorgänge	((	Süreçlerin belgeleri	))
Die Schulung des Personals	((	Personelin eğitimi	))
Die Prüfung der Ausrüstung	((	Ekipmanın testi	))
Das Monitoring der Prozesse	((	Süreçlerin izlenmesi	))
Der Zustand der Maschinen	((	Makinelerin durumu	))
Das Manual für die Benutzung	((	Kullanım Kılavuzu	))
Die Zulassung des Produkts	((	Ürünün onayı	))
Das Risiko der Abweichung	((	Sapma riski	))
Der Vergleich mit der Konkurrenz	((	Rekabetle karşılaştırma	))
Die Aktualisierung der Methoden	((	Yöntemlerin güncellenmesi	))
Die Überwachung der Aktivitäten	((	Faaliyetlerin izlenmesi	))
Der Konsens über die Standards	((	Standartlar üzerindeki fikir birliği	))
Die Verlässlichkeit des Lieferanten	((	Tedarikçinin güvenilirliği	))
Das Profil der Qualität	((	Kalite profili	))
Die Rückverfolgbarkeit der Komponenten	((	Bileşenlerin izlenebilirliği	))
Die Bestätigung des Auftrags	((	Siparişin teyidi	))
Die Lieferzeit des Produkts	((	Ürünün teslimat süresi	))
Der Status der Bestellung	((	Siparişin durumu	))
Die Rechnung des Verkäufers	((	Satıcının faturası	))
Der Versand des Pakets	((	Paketin gönderimi	))
Die Verpackung der Ware	((	Malların ambalajı	))
Die Kommunikation mit dem Kunden	((	Müşteri ile iletişim	))
Die Rückmeldung des Systems	((	Sistemin geri bildirimi	))
Die Zahlung des Käufers	((	Alıcının Ödeme	))
Das Angebot des Dienstleisters	((	Servis Sağlayıcının Teklifi	))
Die Anforderungen des Marktes	((	Piyasanın gereksinimleri	))
Der Rabatt des Produktes	((	Ürünün indirimi	))
Die Qualität der Lieferung	((	Teslimatın kalitesi	))
Die Bewertung des Services	((	Hizmetin değerlendirilmesi	))
Die Stornierung der Bestellung	((	Siparişin iptali	))
Der Kunde des Online-Shops	((	Çevrimiçi mağazanın müşterisi	))
Die Lieferung der Artikel	((	Makalelerin teslimatı	))
Das Feedback zur Transaktion	((	İşlem hakkındaki geri bildirim	))
Die Aktualisierung der Bestandsdaten	((	Envanter verilerinin güncellenmesi	))
Die Sicherheit der Zahlungsmethoden	((	Ödeme yöntemlerinin güvenliği	))
Die Anweisung zur Benutzung	((	Kullanım talimatı	))
Der Vertrag des Lieferanten	((	Tedarikçinin sözleşmesi	))
Die Kapazität des Lagers	((	Deponun kapasitesi	))
Die Vorbereitung der Warensendung	((	Konsinye hazırlanması	))
Der Umtausch des Artikels	((	Makalenin alışverişi	))
Die Bearbeitungszeit der Reklamation	((	Şikayetin işleme süresi	))
Das Protokoll der Lieferung	((	Teslimat protokolü	))
Die Einstellung der Preise	((	Fiyatların ayarı	))
Der Import der Waren	((	Malların ithalatı	))
Die Identifizierung des Problems	((	Sorunu tanımlamak	))
Die Optimierung der Prozesse	((	Süreçlerin optimizasyonu	))
Die Skalierung des Geschäfts	((	İşletmenin ölçeklendirilmesi	))
Das Management der Ressourcen	((	Kaynakların yönetimi	))
Die Abwicklung des Exports	((	İhracatın işlenmesi	))
Die Erneuerung des Sortiments	((	Menzilin yenilenmesi	))
Die Garantie des Herstellers	((	Üreticinin garantisi	))
Die Zustellung an den Kunden	((	Müşteriye teslimat	))
Der Zugang zum Kundenkonto	((	Müşteri hesabına erişim	))
Die Analyse der Beschwerde	((	Şikayetin analizi	))
Die Antwort des Kundendienstes	((	Müşteri Hizmetlerinden Cevap	))
Der Ursprung des Problems	((	Sorunun kökeni	))
Das Verständnis des Kunden	((	Müşteriyi Anlamak	))
Die Bewertung der Situation	((	Durumun değerlendirilmesi	))
Der Lösungsvorschlag des Beraters	((	Danışmanın teklifi	))
Die Zufriedenheit des Kunden	((	Müşterinin memnuniyeti	))
Der Status der Beschwerde	((	Şikayetin durumu	))
Das Ergebnis der Untersuchung	((	Soruşturmanın sonucu	))
Die Dokumentation des Falles	((	Davanın belgeleri	))
Die Kommunikation des Teams	((	Ekibin iletişimi	))
Der Prozess der Nachverfolgung	((	İzleme denemesi	))
Das Ziel des Beschwerdemanagements	((	Şikayet Yönetimi Amacı	))
Die Verbesserung des Services	((	Hizmetin iyileştirilmesi	))
Die Eskalation des Konflikts	((	Çatışmanın yükselmesi	))
Die Rückmeldung des Kunden	((	Müşterinin geri bildirimi	))
Der Eingang der Beschwerde	((	Şikayetin alınması	))
Die Bearbeitung des Anliegens	((	Endişenin işlenmesi	))
Das Feedback des Kunden	((	Müşterinin geri bildirimi	))
Der Verlauf der Kommunikation	((	İletişimin seyri	))
Die Reaktion des Unternehmens	((	Şirketin tepkisi	))
Der Umgang mit der Kritik	((	Eleştiriyle uğraşmak	))
Die Erwartung des Kunden	((	Müşterinin Beklentisi	))
Die Konsequenzen des Fehlers	((	Hatanın sonuçları	))
Die Schnelligkeit der Lösung	((	Çözümün hızı	))
Das Engagement des Mitarbeiters	((	Çalışan Taahhüdü	))
Die Priorität des Problems	((	Sorunun önceliği	))
Der Kontext der Beschwerde	((	Şikayetin bağlamı	))
Die Befugnis des Managers	((	Yöneticinin yetkisi	))
Die Strategie des Beschwerdemanagements	((	Şikayet Yönetimi Stratejisi	))
Die Verantwortung des Teams	((	Takımın sorumluluğu	))
Die Meldung des Vorfalls	((	Olayın mesajı	))
Das Verfahren zur Konfliktlösung	((	Çatışma çözümü için prosedür	))
Die Initiative zur Veränderung	((	Değişim Girişimi	))
Die Resonanz auf die Maßnahme	((	Tedbire yanıt	))
Die Beziehung zum Kunden	((	Müşteri ile ilişki	))
Die Integration der Lösungsansätze	((	Çözümlerin entegrasyonu	))
Die Effizienz der Bearbeitung	((	İşleme etkinliği	))
Der Fokus des Gesprächs	((	Konuşmanın odağı	))
Der Stand des Unternehmens	((	Şirketin Standı	))
Die Präsentation der Produkte	((	Ürünlerin sunumu	))
Der Besucher des Messestands	((	Sergi Standının Ziyaretçisi	))
Die Öffnungszeit der Messe	((	Fuarın açılış zamanı	))
Die Organisation des Events	((	Etkinliğin organizasyonu	))
Die Anzahl der Aussteller	((	Katılımcı sayısı	))
Das Interesse des Publikums	((	İzleyicinin ilgisi	))
Der Erfolg der Veranstaltung	((	Etkinliğin başarısı	))
Die Planung der Messeaktivitäten	((	Ticaret Fuarı faaliyetlerinin planlanması	))
Der Flyer des Unternehmens	((	Şirketin broşürü	))
Die Vorbereitung des Teams	((	Takımın hazırlanması	))
Die Strategie der Produktplatzierung	((	Ürün yerleştirme stratejisi	))
Die Vorstellung des Services	((	Hizmet fikri	))
Der Verkauf der Artikel	((	Makalelerin satışı	))
Das Feedback der Besucher	((	Ziyaretçilerin geri bildirimi	))
Die Lage des Messestands	((	Sergi standının yeri	))
Das Ziel der Messebeteiligung	((	Ticaret Fuarı Katılımının Amacı	))
Der Vorteil der Präsentation	((	Sunumun avantajı	))
Die Informationsbroschüre des Produkts	((	Ürünün bilgi broşürü	))
Das Logo des Unternehmens	((	Şirketin logosu	))
Die Herausforderung der Selbstständigkeit	((	Bağımsızlığın Zorluğu	))
Der Vorteil des eigenen Chefs	((	Kendi patronunuzun avantajı	))
Das Risiko des Unternehmertums	((	Girişimcilik riski	))
Die Freiheit des Arbeitsalltags	((	Günlük işin özgürlüğü	))
Der Erfolg des Geschäftsmodells	((	İş modelinin başarısı	))
Die Investition des Kapitals	((	Sermaye yatırımı	))
Das Ziel der Unabhängigkeit	((	Bağımsızlık hedefi	))
Die Planung der Unternehmensgründung	((	Şirketin Vakfını Planlama	))
Die Verantwortung des Geschäftsführers	((	Genel müdürün sorumluluğu	))
Die Flexibilität der Arbeit	((	İşin esnekliği	))
Der Kunde des Dienstleisters	((	Servis sağlayıcının müşterisi	))
Die Kontrolle der Finanzen	((	Finansın Kontrolü	))
Die Strategie des Marketings	((	Pazarlama stratejisi	))
Die Schwierigkeit der Entscheidungsfindung	((	Karar verme zorluğu	))
Der Umsatz des Unternehmens	((	Şirketin cirosu	))
Die Vision der Firma	((	Şirketin vizyonu	))
Das Netzwerk des Freelancers	((	Freelancer'ın ağı	))
Die Fähigkeit zur Selbstorganisation	((	Kendini örgütleme yeteneği	))
Das Feedback der Klienten	((	Müşterilerden gelen geri bildirim	))
Die Balance der Work-Life-Balance	((	İş-yaşam dengesi dengesi	))
Die Höhe der Abgaben	((	Vergilerin miktarı	))
Die Qualität der Leistungen	((	Hizmetlerin kalitesi	))
Die Fälligkeit der Zahlung	((	Ödeme tarihi	))
Die Erstattung der Kosten	((	Maliyetlerin geri ödemesi	))
Das Niveau der Dienstleistung	((	Hizmet seviyesi	))
Die Anforderungen an die Leistungen	((	Hizmetler için gereksinimler	))
Die Überprüfung der Abrechnung	((	Faturalandırmayı kontrol etmek	))
Der Umfang der Erstattungen	((	Geri ödemelerin kapsamı	))
Das Kriterium für die Leistungsbewertung	((	Performans Değerlendirmesi Kriteri	))
Die Senkung der Steuern	((	Vergilerin azaltılması	))
Die Erhöhung der Beiträge	((	Katkılardaki artış	))
Die Verbesserung der Angebote	((	Tekliflerin iyileştirilmesi	))
Die Verteilung der Ressourcen	((	Kaynakların dağılımı	))
Die Beurteilung der Ergebnisse	((	Sonuçların değerlendirilmesi	))
Der Zugang zu den Leistungen	((	Hizmetlere erişim	))
Die Reduzierung der Abgaben	((	Vergilerin azaltılması	))
Der Anspruch auf die Dienstleistungen	((	Hizmet hakkı	))
Das Formular für die Anmeldung	((	Kayıt formu	))
Die Optimierung der Prozesse	((	Süreçlerin optimizasyonu	))
Die Implementierung der Änderungen	((	Değişikliklerin uygulanması	))
Die Beratung des Kunden	((	Müşteriye danışmanlık	))
Der Erhalt der Quittung	((	Makbuzun alınması	))
Die Bewertung der Leistung	((	Hizmetin değerlendirilmesi	))
Die Skalierung der Gebühren	((	Ücretlerin ölçeklendirilmesi	))
Der Nutzen der Angebote	((	Tekliflerin faydaları	))
Die Verwaltung der Mittel	((	Fonların yönetimi	))
Der Vergleich der Anbieter	((	Sağlayıcıların karşılaştırılması	))
Die Anpassung der Tarife	((	Tarifelerin ayarlanması	))
Die Veröffentlichung der Informationen	((	Bilgilerin yayınlanması	))
Die Erfüllung der Pflichten	((	Görevlerin yerine getirilmesi	))
Die Erweiterung der Leistungspalette	((	Hizmet yelpazesinin genişlemesi	))
Die Durchführung der Bewertungen	((	İncelemelerin uygulanması	))
Die Korrektur der Fehler	((	Hataların düzeltilmesi	))
Die Aktualisierung der Daten	((	Verilerin güncellenmesi	))
Die Reklamation der Dienstleistungen	((	Hizmetlerin şikayeti	))
Die Spezifikation der Anforderungen	((	Gereksinimlerin belirtimi	))
Die Transparenz der Zahlungen	((	Ödemelerin şeffaflığı	))
Die Kontrolle der Leistungserbringung	((	Hizmet sunumunun kontrolü	))
Die Maximierung der Profite	((	Karı en üst düzeye çıkarmak	))
Die Anforderung der Rückerstattung	((	Geri ödemenin isteği	))
