Die Adresse des Kunden	((	Cinwaanka macaamiisha	))
Der Name der Firma	((	Magaca shirkadda	))
Die Telefonnummer des Lieferanten	((	Lambarka taleefanka iibiyaha	))
Der Bericht des Praktikanten	((	Warbixinta Interns	))
Die Entscheidung des Managers	((	Go'aanka maamulaha	))
Das Büro des Chefs	((	Xafiiska Maamulaha	))
Die E-Mail des Kollegen	((	Email saaxiibkiis	))
Die Rechnung des Unternehmens	((	Qaansheegta shirkadda	))
Der Vertrag des Arbeitnehmers	((	Qandaraaska shaqaalaha	))
Das Gehalt des Angestellten	((	Mushadeynta shaqaalaha	))
Die Bestellung des Kunden	((	Amarka macaamiisha	))
Das Produkt des Herstellers	((	Soo-saaraha soosaarka	))
Die Rechte des Autors	((	Xuquuqda Qoraaga	))
Die Website des Händlers	((	Bogagga shabakadda ganacsadaha	))
Die Aufgaben der Sekretärin	((	Teerarka xoghayaha	))
Der Erfolg des Teams	((	Guusha kooxda	))
Die Kritik des Experten	((	Dhaleecaynta Khabiirka	))
Die Meinung des Mitarbeiters	((	Ra'yiga shaqaalaha	))
Die Verantwortung des Ingenieurs	((	Masuuliyadda injineerka	))
Die Vorschläge der Beraterin	((	Talooyinka lataliyaha	))
Die Vorteile des Online-Handels	((	Faa'iidooyinka ganacsiga khadka tooska ah	))
Die Strategie des Unternehmens	((	Istaraatiijiyadda Shirkadda	))
Das Profil des Kandidaten	((	Muuqaalka musharraxiinta	))
Die Investitionen des Investors	((	Maalgalinta Maalgashiga	))
Die Sicherheit der Daten	((	Amniga xogta	))
Der Umsatz des Geschäfts	((	Muuqaalka ganacsiga	))
Die Partner des Projekts	((	Wada-hawlgalayaasha Mashruuca	))
Die Konditionen des Vertrags	((	Shuruudaha heshiiska	))
Die Pflichten des Arbeitgebers	((	Waajibaadka loo shaqeeyaha	))
Die Ziele der Kampagne	((	Yoolalka ololaha	))
Die Anforderungen des Marktes	((	Shuruudaha suuqa	))
Die Entwicklung des Marktes	((	Horumarinta suuqa	))
Die Funktion des Tools	((	Shaqada aaladda	))
Die Rolle des Direktors	((	Doorka agaasimaha	))
Die Aufzeichnungen des Treffens	((	Diiwaanada kulanka	))
Die Erwartungen des Kunden	((	Macaamilka Macaamilka	))
Die Qualifikationen des Bewerbers	((	Aqoonta codsadaha	))
Die Methoden des Coaches	((	Hababka tababarayaasha	))
Die Lösungen des Problems	((	Xalka dhibaatada	))
Die Ergebnisse der Umfrage	((	Natiijooyinka sahanka	))
Die Kompetenzen des Leiters	((	Kartida jaranjarada	))
Die Perspektiven des Absolventen	((	Rajooyinka ka qalin jabiyay	))
Die Präsentation des Verkäufers	((	Soo bandhigida iibiyaha	))
Der Ruf des Unternehmens	((	Sumcadda shirkadda	))
Die Philosophie der Firma	((	Falsafada shirkadda	))
Die Technologie des Produkts	((	Tikniyoolajiyadda sheyga	))
Die Vision des Gründers	((	Aragtida aasaasaha	))
Die Kultur des Betriebs	((	Dhaqanka shirkadda	))
Der Schutz des Konsumenten	((	Ilaalinta macaamilka	))
Die Identität der Marke	((	Aqoonsiga astaanta	))
Die Konkurrenz des Geschäfts	((	Tartanka ganacsiga	))
Die Kritiken des Films	((	Faallooyinka filimka	))
Die Stärken des Konzepts	((	Awooda fikradda	))
Die Fähigkeiten des Arbeiters	((	Xirfadaha Shaqaalaha	))
Die Zufriedenheit des Kunden	((	Ku qanacsanaanta macaamilka	))
Die Details des Plans	((	Faahfaahinta qorshaha	))
Die Beweise der Theorie	((	Caddeynta aragtida	))
Die Geschichte des Landes	((	Taariikhda dalka	))
Die Herausforderungen des Jobs	((	Caqabadaha shaqada	))
Die Angebote des Shops	((	Deeqda dukaanka	))
Der Wert des Hauses	((	Qiimaha guriga	))
Die Risiken der Investition	((	Khataraha maalgashiga	))
Die Prinzipien der Organisation	((	Mabaadi'da ururka	))
Der Charakter des Kollegen	((	Dabeecadda saaxiibkiis	))
Die Nachteile der Technologie	((	Faa'iido darrooyinka tikniyoolajiyadda	))
Die Aktien des Unternehmens	((	Saamiyada shirkadda	))
Die Gründe der Entscheidung	((	Sababaha go'aanka	))
Die Merkmale des Produkts	((	Astaamaha sheyga	))
Die Dienstleistungen des Anbieters	((	Adeegyada Bixiyaha	))
Die Mitglieder des Vereins	((	Xubnaha Ururka	))
Die Grundsätze der Politik	((	Mabaadi'da siyaasada	))
Der Geschmack des Weins	((	Dhadhanka khamriga	))
Die Faktoren des Wachstums	((	Waxyaabaha Kobaca ah	))
Die Preise des Anbieters	((	Qiimaha bixiyaha	))
Die Eigenschaften des Materials	((	Guryaha maaddada	))
Die Alternativen der Lösung	((	Beddelka xalka	))
Die Bedeutung des Wortes	((	Macnaha erayga	))
Die Fristen der Aufgabe	((	Waqtiga kama dambeysta ah ee hawsha	))
Die Eigentümer der Immobilie	((	Milkiilayaasha hantida	))
Die Änderungen der Richtlinien	((	Isbedelada tilmaamaha	))
Die Sitzung des Vorstands	((	Kulanka guddiga	))
Die Qualität des Services	((	Tayada adeegga	))
Der Zustand des Gebäudes	((	Xaaladda dhismaha	))
Die Botschaft des Textes	((	Farriinta qoraalka	))
Die Dynamik des Marktes	((	Dhaqdhaqaaqa suuqa	))
Die Fähigkeiten des Führers	((	Xirfadaha hogaamiyaasha	))
Die Verbindungen des Computers	((	Xiriirinta kumbuyuutarka	))
Die Wirkung des Medikaments	((	Saamaynta daroogada	))
Die Kapazität des Akkus	((	Awoodda baytariga	))
Die Struktur des Programms	((	Qaab-dhismeedka barnaamijka	))
Der Einfluss der Regierung	((	Saamaynta ay leedahay dawladda	))
Die Kapitel des Buches	((	Cutubyada buugga	))
Der Umfang des Projekts	((	Baaxadda mashruuca	))
Die Ursachen des Problems	((	Sababaha dhibaatada	))
Die Hauptstadt des Landes	((	Caasimada dalka	))
Die Resultate der Studie	((	Natiijooyinka daraasadda	))
Die Farben des Regenbogens	((	Midabada qaansoroobaad	))
Die Vorteile des Systems	((	Faa'iidooyinka nidaamka	))
Die Wünsche des Kindes	((	Rabitaanka ilmaha	))
Die Traditionen des Volkes	((	Caadooyinka dadka	))
Die Strategie des Marketings	((	Istaraatiijiyadda suuq geynta	))
Die Bilanz des Geschäftsjahres	((	Isku dheelitirka sanadka maaliyadeed	))
Der Jahresbericht des Unternehmens	((	Warbixinta Sannadlaha ah ee Shirkadda	))
Die Kompetenz des Teams	((	Kartida kooxda	))
Die Innovationskraft des Unternehmens	((	Xoogga cusub ee shirkadda	))
Der Kundenservice des Anbieters	((	Adeegga macaamiisha ee bixiyaha	))
Die Handelsbeziehungen des Landes	((	Xiriirka Ganacsiga ee dalka	))
Die Unternehmenskultur der Firma	((	Dhaqanka shirkadda shirkadda	))
Die Vertriebsstrategie des Produkts	((	Istaraatiijiyadda iibka ee sheyga	))
Die Rendite des Investments	((	Soo laabashada maalgashiga	))
Die Verschwiegenheitspflicht des Angestellten	((	Xirmooyinka sirta ee shaqaalaha	))
Die Leistungsindikatoren des Projekts	((	Tilmaamayaasha Mashruuca ee Mashruuca	))
Die Liquidität des Unternehmens	((	Dareeraha shirkadda	))
Die Gehaltserhöhung des Mitarbeiters	((	Mushaharka shaqaalaha ayaa kordhay	))
Die Marktpositionierung des Produkts	((	Meesha suuqa ee sheyga	))
Die Geschäftsbeziehung des Partners	((	Xiriirka ganacsi ee lammaanaha	))
Die Wettbewerbsfähigkeit des Unternehmens	((	Tartanka shirkadda	))
Die Nachhaltigkeitsstrategie der Firma	((	Istaraatiijiyadda Joogtada ee Shirkadda	))
Die Kernkompetenzen der Organisation	((	Awoodda aasaasiga ah ee ururka	))
Die Profitabilität des Geschäftsmodells	((	Faa iidada qaabka ganacsiga	))
Die Adresse des Kunden	((	Cinwaanka macaamiisha	))
Der Name des Lieferanten	((	Magaca alaab-qeybiyaha	))
Die Rechnung des Verkäufers	((	Qaansheegta iibiyaha	))
Die Produkte des Herstellers	((	Alaabada soo-saaraha	))
Der Standort des Büros	((	Goobta xafiiska	))
Die Größe des Unternehmens	((	Cabirka shirkadda	))
Der Preis des Artikels	((	Qiimaha maqaalka	))
Die Anforderungen des Jobs	((	Shuruudaha shaqada	))
Der Chef des Teams	((	Madaxa kooxda	))
Die Öffnungszeiten des Geschäfts	((	Waqtiyada furitaanka ee ganacsiga	))
Der Rabatt des Verkäufers	((	Qiimaha iibiyaha	))
Die Lieferzeit des Produkts	((	Waqtiga gudbinta ee badeecada	))
Die Qualität der Dienstleistung	((	Tayada adeegga	))
Der Umsatz des Geschäfts	((	Muuqaalka ganacsiga	))
Der Vertrag des Anbieters	((	Qandaraaska Bixiyaha	))
Der Kunde des Beraters	((	Macaamiisha lataliyaha	))
Die Aufgaben des Managers	((	Hawlaha maamulaha	))
Die Verspätung des Fluges	((	Dib u dhaca duulimaadka	))
Die Ergebnisse des Meetings	((	Natiijooyinka kulanka	))
Der Vorteil des Angebots	((	Faa'iidada dalabka	))
Die Meinung des Kunden	((	Aragtida macaamiisha	))
Die Strategie des Unternehmens	((	Istaraatiijiyadda Shirkadda	))
Die Filiale des Banken	((	Laanta bangiyada	))
Die Methoden der Forschung	((	Hababka cilmi baarista	))
Die Partner des Projekts	((	Wada-hawlgalayaasha Mashruuca	))
Die Ziele des Workshops	((	Yoolalka aqoon isweydaarsiga	))
Der Bonus des Mitarbeiters	((	Gunnada shaqaalaha	))
Die Politik des Unternehmens	((	Siyaasadda Shirkadda	))
Der Kredit des Kunden	((	Amaahda macaamiisha	))
Die Dienstleistungen des Hotels	((	Adeegyada hoteelka	))
Der Lohn des Arbeiters	((	Mushaharka shaqaalaha	))
Die Beförderung des Angestellten	((	Dhiirrigelinta shaqaalaha	))
Der Bericht des Praktikanten	((	Warbixinta Interns	))
Die Erfahrungen des Praktikanten	((	Waayo-aragnimada intern	))
Die Zahlungsmethoden des Shops	((	Qaababka lacag bixinta ee dukaanka	))
Die Erwartungen des Investors	((	Filashooyinka maalgashadayaasha	))
Der Gewinn des Unternehmens	((	Faa'iidada shirkadda	))
Die Schulungen des Personals	((	Tababarka shaqaalaha	))
Die Rolle des Managers	((	Doorka Maareeyaha	))
Die Entwicklungen des Marktes	((	Horumarka suuqa	))
Die Kontaktdaten des Lieferanten	((	Faahfaahinta xiriirka ee alaab-qeybiyaha	))
Die Verantwortung des Managers	((	Masuuliyada maamulaha	))
Die Frist des Vertrags	((	Waqtiga kama dambeysta ah ee heshiiska	))
Der Geschäftspartner des Unternehmens	((	Ururka Ganacsiga Shirkadda Shirkadda	))
Die Fähigkeiten des Bewerbers	((	Xirfadaha codsadaha	))
Die Vorgeschichte des Produkts	((	Taariikhda sheyga	))
Der Beitrag des Mitarbeiters	((	Ku biirinta shaqaalaha	))
Die Zukunft des Unternehmens	((	Mustaqbalka shirkadda	))
Die Beurteilung des Praktikums	((	Qiimaynta shaqo baradnimada	))
Die Bestellung des Kunden	((	Amarka macaamiisha	))
Die Perspektiven des Markts	((	Rajada suuqa	))
Die Referenzen des Beraters	((	Tixraacyada lataliyaha	))
Die Kritik des Vorgesetzten	((	Dhaleeceynta kormeeraha	))
Die Technologie des Produkts	((	Tikniyoolajiyadda sheyga	))
Die Risiken des Geschäfts	((	Khataraha ganacsiga	))
Die Informationen des Anbieters	((	Macluumaadka bixiyaha	))
Der Katalog des Händlers	((	Kaatalogga Dareeyaha	))
Die Präsentation des Projekts	((	Soo bandhigida mashruuca	))
Die Abteilung des Ingenieurs	((	Waaxda Injineerka	))
Die Produktlinie des Herstellers	((	Khadka sheyga soo-saaraha	))
Der Rat des Kollegen	((	Talada saaxiibbada ah	))
Die Kennzahlen des Berichts	((	Tirooyinka ugu muhiimsan ee warbixinta	))
Der Charakter des Unternehmens	((	Dabeecadda shirkadda	))
Die Anerkennung des Chefs	((	Aqoonsiga madaxa	))
Die Aufstiegsmöglichkeiten des Jobs	((	Fursadaha shaqo ee shaqada	))
Der Erfolg des Teams	((	Guusha kooxda	))
Die Herausforderungen des Marktes	((	Caqabadaha suuqa	))
Die Änderungen der Regeln	((	Isbedelada xeerarka	))
Die Stärken des Produkts	((	Awooda sheyga	))
Die Zufriedenheit des Kunden	((	Ku qanacsanaanta macaamilka	))
Die Auswirkungen der Entscheidung	((	Saamaynta go'aanka	))
Die Schwächen des Plans	((	Daciifnimada qorshaha	))
Der Geschmack des Weins	((	Dhadhanka khamriga	))
Der Vorschlag des Kollegen	((	Soojeedinta saaxiibbada	))
Die E-Mail-Adresse des Kundendiensts	((	Cinwaanka emaylka ee Adeegga Macaamiisha	))
Der Fortschritt des Projekts	((	Horumarka mashruuca	))
Der Nutzen der Software	((	Isticmaalka softiweerka	))
Die Investitionen des Unternehmens	((	Maalgashiga shirkadda	))
Die Bestimmungen des Vertrags	((	Shuruucda heshiiska	))
Der Abschluss des Geschäftsjahres	((	Gabagabada sanadka maaliyadeed	))
Die Besprechung des Projekts	((	Dooda ka wada hadalka mashruuca	))
Die Sicherheit des Systems	((	Nabdoonaanta nidaamka	))
Die Erklärung des Professors	((	Faahfaahinta borofiladda	))
Der Fehler des Systems	((	Khaladaadka nidaamka	))
Die Anleitung des Geräts	((	Tilmaamaha aaladda	))
Die Details des Plans	((	Faahfaahinta qorshaha	))
Die Tätigkeiten des Unternehmens	((	Hawlaha shirkadda	))
Der Beruf des Vaters	((	Xirfadlaha aabaha	))
Die Menge der Ware	((	Xaddiga alaabada	))
Die Ansicht des Kunden	((	Aragtida macaamiisha	))
Der Inhalt des Buches	((	Waxa ku jira buugga	))
Die Schritte des Prozesses	((	Tallaabooyinka hawsha	))
Die Merkmale des Produkts	((	Astaamaha sheyga	))
Die Fähigkeiten des Bewerbers	((	Xirfadaha codsadaha	))
Die Zuständigkeit des Managers	((	Masuuliyadda Maareeyaha	))
Die Mitarbeiter des Monats	((	Shaqaalaha bisha	))
Die Prinzipien des Unternehmens	((	Mabaadi'da shirkadda	))
Die Zeiten der Öffnungszeiten	((	Waqtiyada waqtiyada furitaanka	))
Die Alternativen des Projekts	((	Beddelka mashruuca	))
Der Vorteil des Angebots	((	Faa'iidada dalabka	))
Die Erwartungen des Chefs	((	Rajada madaxda	))
Die Vorstellung des Produkts	((	Fikradda sheyga	))
Die Leistungen des Dienstleisters	((	Adeegyada Adeeg Bixiyaha	))
Der Bedarf des Marktes	((	Baahida loo qabo suuqa	))
Der Ursprung des Problems	((	Asalka dhibaatada	))
Die Frist des Projekts	((	Waqtiga kama dambeysta ah ee mashruuca	))
Die Nachteile des Vorschlags	((	Faa'iido darrooyinka soo jeedinta	))
Die Vorteile der Methode	((	Faa'iidooyinka habka	))
Der Zweck der Studie	((	Ujeedada daraasadda	))
Die Genehmigung des Antrags	((	Oggolaanshaha dalabka	))
Der Verlust des Unternehmens	((	Luminta shirkadda	))
Der Beitrag des Mitglieds	((	Ku-biirinta xubinta	))
Die Bedingungen der Vereinbarung	((	Shuruudaha heshiiska	))
Die Motivation des Teams	((	Dhiirigelinta kooxda	))
Die Eigenschaften des Materials	((	Guryaha maaddada	))
Der Inhaber des Patents	((	Milkiilaha patent	))
Der Ursprung des Konflikts	((	Asalka iskahorimaadka	))
Die Relevanz des Themas	((	Ku habboonaanta mowduuca	))
Die Aktualität der Nachrichten	((	Isu-soo-nooleynta wararka	))
Die Ressourcen des Projekts	((	Kheyraadka Mashruuca	))
Die Lieferzeit des Produkts	((	Waqtiga gudbinta ee badeecada	))
Der Standort des Büros	((	Goobta xafiiska	))
Die Strategie des Unternehmens	((	Istaraatiijiyadda Shirkadda	))
Die Qualität der Dienstleistung	((	Tayada adeegga	))
Die Aufgaben des Praktikanten	((	Hawlaha shirkadda	))
Die Größe des Teams	((	Cabirka kooxda	))
Der Ruf des Herstellers	((	Wicitaanka soo-saaraha	))
Die Loyalität der Kunden	((	Daacadnimada macaamiisha	))
Die Beschwerde des Klienten	((	Cabashada macmiilka	))
Die Versprechen des Verkäufers	((	Balanqaadyada iibiyaha	))
Die Ansprüche der Stakeholder	((	Sheegashada daneeyayaasha	))
Die Funktionen der Software	((	Hawlaha softiweerka	))
Die Vision des Gründers	((	Aragtida aasaasaha	))
Der Umsatz des Geschäfts	((	Muuqaalka ganacsiga	))
Die Philosophie des Unternehmens	((	Falsafada shirkadda	))
Der Wert des Investments	((	Qiimaha maalgashiga	))
Der Kunde des Monats	((	Macmiilka bisha	))
Die Lösung des Problems	((	Xalka dhibaatada	))
Die Produkte des Anbieters	((	Alaabada Bixiyeyaasha	))
Die Erfolge des Teams	((	Guusha kooxda	))
Die Ziele des Projekts	((	Yoolalka mashruuca	))
Die Rolle des Direktors	((	Doorka agaasimaha	))
Der Gewinn des Unternehmens	((	Faa'iidada shirkadda	))
Die Meinung des Kritikers	((	Aragtida dhaleeceynta	))
Der Nutzen der Schulung	((	Faa'iidada tababarka	))
Die Ergebnisse der Umfrage	((	Natiijooyinka sahanka	))
Der Grund des Ausfalls	((	Sababta guul darrooyinka	))
Die Empfehlungen des Beraters	((	Talooyinka lataliyaha	))
Die Entwicklung des Marktes	((	Horumarinta suuqa	))
Die Forderungen der Arbeitnehmer	((	Baahiyaha shaqaalaha	))
Die Stärken des Bewerbers	((	Awooda codsadaha	))
Der Kurs des Euro	((	Koorsada euro	))
Die Dienstleistungen des Unternehmens	((	Adeegyada Shirkadda	))
Der Preis des Tickets	((	Qiimaha tikidhada	))
Die Geschichte des Staates	((	Taariikhda gobolka	))
Der Chef des Bereichs	((	Madaxa aagga	))
Die Anforderungen des Jobs	((	Shuruudaha shaqada	))
Die Änderungen der Politik	((	Isbedelada siyaasada	))
Die Entscheidung des Gerichts	((	Go'aanka maxkamada	))
Die Partner des Projekts	((	Wada-hawlgalayaasha Mashruuca	))
Die Kultur des Unternehmens	((	Dhaqanka shirkadda	))
Die Struktur des Programms	((	Qaab-dhismeedka barnaamijka	))
Der Einfluss des Wetters	((	Saamaynta cimilada	))
Der Wettbewerb des Marktes	((	Tartanka suuqa	))
Die Strategien des Managements	((	Xeeladaha Maamulka	))
Der Zugang zu den Informationen	((	Helitaanka macluumaadka	))
Die Richtlinien der Organisation	((	Tilmaamaha Ururka	))
Die Rechte des Arbeitnehmers	((	Xuquuqda shaqaalaha	))
Die Analyse des Spezialisten	((	Falanqaynta takhasuska	))
Der Fokus des Treffens	((	Ahmiyada kulanka	))
Die Probleme des Systems	((	Dhibaatooyinka nidaamka	))
Die Chancen des Marktes	((	Fursadaha suuqa	))
Die Komponenten des Produkts	((	Waxyaabaha ay ka kooban yihiin sheyga	))
Der Schutz des Umwelts	((	Ilaalinta deegaanka	))
Die Erwartungen des Investors	((	Filashooyinka maalgashadayaasha	))
Die Innovationen des Unternehmens	((	Dayactirka Shirkadda	))
Die Beziehungen des Lieferanten	((	Xiriirka alaab-qeybiyaha	))
Die Zertifizierungen des Produkts	((	Shahaadooyinka sheyga	))
Der Prozess des Lernens	((	Geedi socodka barashada	))
Die Verantwortlichkeiten des Managers	((	Waajibaadka Maamulayaasha	))
Die Risiken des Vorhabens	((	Khataraha Mashruuca	))
Der Status des Auftrags	((	Xaaladda amarka	))
Die Technologien des Betriebs	((	Teknolojiyada shirkadda	))
Der Beitrag zur Konferenz	((	Ku biirinta shirka shirka	))
Die Auswirkungen der Entscheidung	((	Saamaynta go'aanka	))
Der Hauptsitz der Firma	((	Xarunta Shirkadda	))
Die Kriterien der Auswahl	((	Shuruudaha xulashada	))
Der Zweck der Recherche	((	Ujeedada cilmi baarista	))
Der Nutzer des Forums	((	Adeegsiga Madasha	))
Die Methoden der Forschung	((	Hababka cilmi baarista	))
Die Stellungnahme des Experten	((	Bayaanka khabiirka	))
Die Schwächen des Plans	((	Daciifnimada qorshaha	))
Die Konsequenzen der Handlungen	((	Cawaaqibta ficilada	))
Die Pflichten des Arbeitgebers	((	Waajibaadka loo shaqeeyaha	))
Der Gebrauch des Werkzeugs	((	Adeegsiga aaladda	))
Die Perspektiven des Marktes	((	Aragtida suuqa	))
Die Qualifikationen des Kandidaten	((	Aqoonsiga musharixiinta	))
Der Ursache des Problems	((	Sababta dhibaatada	))
Der Charakter des Teams	((	Dabeecadda kooxda	))
Die Einführung des Modells	((	Soo bandhigida moodalka	))
Die Vorteile des Systems	((	Faa'iidooyinka nidaamka	))
Die Funktion des Gerätes	((	Shaqada aaladda	))
Der Mangel an Informationen	((	Macluumaad la'aanta	))
Die Effizienz der Methode	((	Hufnaanta habka	))
Die Prinzipien des Designs	((	Mabaadi'da naqshadeynta	))
Die Integrität der Daten	((	Daacadnimada xogta	))
Die Fähigkeiten des Roboters	((	Awooda robotka	))
Der Ursprung des Wortes	((	Asalka ereyga	))
Die Verwendung der Technologie	((	Adeegsiga tikniyoolajiyadda	))
Die Details des Vertrags	((	Faahfaahinta heshiiska	))
Die Eigenschaften der Lösung	((	Guryaha xalka	))
Der Geschmack des Weines	((	Dhadhanka khamriga	))
Die Flexibilität des Zeitplans	((	Dabacsanaanta jadwalka	))
Der Umfang des Projekts	((	Baaxadda mashruuca	))
Die Stabilität des Systems	((	Xasilloonida nidaamka	))
Die Theorien des Wissenschaftlers	((	Fikradaha saynisyahanku	))
Die Präferenzen der Konsumenten	((	Xulashooyinka macaamiisha	))
Die Ursachen des Phänomens	((	Sababaha ifafaale	))
Der Bedarf an Spezialisten	((	Baahida takhasusleyaasha	))
Die Anwendung des Gesetzes	((	Codsiga Sharciga	))
Die Bedeutung der Berufsorientierung	((	Muhiimadda hanuuninta xirfadeed	))
Die Kriterien der Berufswahl	((	Shuruudaha doorashada Xirfadda	))
Die Methoden der Berufsberatung	((	Hababka latalinta xirfadaha	))
Die Chancen der Weiterbildung	((	Fursadaha tababar dheeraad ah	))
Die Herausforderungen des Berufseinstiegs	((	Caqabadaha soo galitaanka shaqada	))
Die Strategien der Berufsentwicklung	((	Istaraatiijiyadaha Horumarinta Xirfadaha	))
Der Beginn der Berufslaufbahn	((	Bilowga xirfadda xirfadeed	))
Die Aspekte der Berufszufriedenheit	((	Dhinacyada qanacsanaanta xirfadda	))
Der Zweck der Berufsplanung	((	Ujeedada qorshaynta xirfadeed	))
Die Vorteile der Berufsausbildung	((	Faa'iidooyinka tababarka xirfadda	))
Der Einfluss der Berufserfahrung	((	Saamaynta khibradda xirfadeed	))
Die Faktoren der Berufswahl	((	Waxyaabaha la doorbidayo Xirfadda	))
Die Dauer der Berufsausbildung	((	Muddada tababarka xirfadda	))
Die Elemente der Berufsvorbereitung	((	Waxyaabaha ku saabsan diyaarinta xirfadda	))
Die Schwierigkeiten des Berufswechsels	((	Dhibaatooyinka isbedelka shaqooyinka	))
Die Perspektiven des Berufsfeldes	((	Aragtiyaha duurka xirfadeed	))
Die Komponenten der Berufsqualifikation	((	Waxyaabaha ay ka kooban yihiin shahaadada xirfadeed	))
Die Rolle der Berufsorientierung	((	Doorka hanuuninta xirfadeed	))
Die Anforderungen des Berufslebens	((	Shuruudaha nolosha xirfadda	))
Der Nutzen der Berufsinformation	((	Faa'iidooyinka macluumaadka xirfadeed	))
Die Etappen der Berufskarriere	((	Marxaladaha shaqada xirfadeed ee xirfadda leh	))
Die Motivation zur Berufswahl	((	Dhiirrigelinta doorashada shaqo	))
Die Folgen der Berufsentscheidung	((	Cawaaqibta go'aanka xirfadda	))
Der Ort der Berufsausbildung	((	Meesha tababarka xirfadda	))
Die Voraussetzungen für die Berufstätigkeit	((	Sharfeyn loogu talagalay waxqabadka xirfadeed	))
Die Kenntnisse im Berufsfeld	((	Aqoonta duurka xirfadeed	))
Der Ablauf der Berufsorientierung	((	Koorsada hanuuninta xirfadeed	))
Die Wirkung der Berufspraxis	((	Saamaynta ku dhaqanka xirfadeed	))
Die Prinzipien der Berufsethik	((	Mabaadi'da anshaxa xirfadda	))
Die Methodik der Berufsförderung	((	Qaabka horumarka xirfadeed	))
Die Optionen im Berufsumfeld	((	Xulashooyinka jawiga xirfadeed	))
Der Wert der Berufserfahrung	((	Qiimaha khibradda xirfadeed	))
Die Alternativen zur Berufsorientierung	((	Waxyaabaha kale ee loo beddelo hanuuninta shaqada	))
Die Investition in die Berufsbildung	((	Maalgashiga tababarka xirfadda	))
Die Kritik an der Berufsausbildung	((	Dhaleecaynta tababarka xirfadda	))
Der Bedarf an beruflichen Kompetenzen	((	Baahida loo qabo xirfado xirfad leh	))
Die Präferenz für einen Berufszweig	((	Doorbidida laanta xirfadlaha ah	))
Der Vorteil einer Berufsspezialisierung	((	Faa'iidada takhasuska xirfadeed	))
Die Integration in den Berufsmarkt	((	Is dhexgalka suuqa xirfadeed	))
Die Ausstattung des Arbeitsplatzes	((	Qalabka goobta shaqada	))
Die Struktur des Arbeitsumfeldes	((	Qaab dhismeedka jawiga shaqada	))
Die Regeln der Arbeitswelt	((	Xeerarka adduunka ee shaqada	))
Die Dynamik des Arbeitsmarktes	((	Dhaqdhaqaaqa suuqa shaqada	))
Die Bedingungen des Arbeitplatzes	((	Shuruudaha goobta shaqada	))
Die Herausforderungen der Arbeitswelt	((	Caqabadaha adduunka shaqada	))
Die Vorteile des Homeoffice	((	Faa'iidooyinka Home Office	))
Der Lärm des Arbeitsplatzes	((	Dhawaqa goobta shaqada	))
Die Kultur der Arbeitsgemeinschaft	((	Dhaqanka kooxda shaqada	))
Die Veränderungen in der Arbeitswelt	((	Isbedelada adduunka ee shaqada	))
Die Rolle der Arbeitsorganisation	((	Doorka Ururka Shaqada	))
Die Zukunft der Arbeitswelt	((	Mustaqbalka adduunka shaqada	))
Der Druck des Arbeitslebens	((	Cadaadiska nolosha shaqada	))
Die Verantwortung des Arbeitgebers	((	Masuuliyadda loo shaqeeyaha	))
Die Sicherheit am Arbeitsplatz	((	Amniga goobta shaqada	))
Die Anforderungen des Arbeitsalltags	((	Shuruudaha shaqada maalinlaha ah	))
Der Einfluss der Arbeitsbedingungen	((	Saamaynta xaaladaha shaqada	))
Die Perspektiven des Arbeitsfeldes	((	Aragtiyaha duurka ee shaqada	))
Der Beitrag der Arbeitnehmer	((	Tabarucaad shaqaalaha	))
Die Ethik der Arbeitswelt	((	Akhlaaqda adduunka ee shaqada	))
Der Schutz der Arbeitsumgebung	((	Ilaalinta jawiga shaqada	))
Die Aufgaben des Arbeitnehmers	((	Hawlaha shaqaalaha	))
Der Wert der Arbeitsethik	((	Qiimaha anshaxa shaqada	))
Die Kriterien für die Arbeitszufriedenheit	((	Shuruudaha qanacsanaanta shaqada	))
Die Fähigkeiten des Arbeitsteams	((	Xirfadaha kooxda shaqada	))
Die Politik des Unternehmens	((	Siyaasadda Shirkadda	))
Der Fokus der Arbeitsstrategie	((	Diiradda la saaray istiraatiijiyadda shaqada	))
Die Qualität der Arbeitsergebnisse	((	Tayada natiijooyinka shaqada	))
Der Vorteil flexibler Arbeitszeiten	((	Faa'iidada saacadaha shaqada ee dabacsan	))
Die Risiken der Arbeitsbedingungen	((	Khataraha xaaladaha shaqada	))
Die Zufriedenheit am Arbeitsplatz	((	Ku qanacsanaanta goobta shaqada	))
Die Merkmale einer erfolgreichen Arbeitskultur	((	Astaamaha dhaqanka shaqada ee guuleysta	))
Die Komplexität der Arbeitswelt	((	Kakanaanta adag ee adduunka	))
Die Prinzipien des Arbeitsrechts	((	Mabaadi'da sharciga shaqada	))
Die Innovationskraft des Arbeitsplatzes	((	Awooda hal-abuurka ee goobta shaqada	))
Die Auswirkungen der Arbeitssicherheit	((	Saamaynta nabadgelyada shaqada	))
Die Barrieren in der Arbeitswelt	((	Caqabadaha adduunka shaqada	))
Der Umgang mit Stress am Arbeitsplatz	((	Wax ka qabashada walaaca goobta shaqada	))
Die Erwartungen an die Arbeitnehmer	((	Filashooyinka Shaqaalaha	))
Die Struktur des Bewerbungsschreibens	((	Qaab dhismeedka warqadda dalabka	))
Die Anforderungen des Bewerbungsprozesses	((	Shuruudaha nidaamka arjiga	))
Die Rolle des Bewerbungsgesprächs	((	Doorka wareysiga	))
Der Inhalt des Lebenslaufs	((	Waxa ku jira manhajka manhajka Vitae	))
Die Relevanz des Motivationsschreibens	((	Ku habboonaanta xarafka dhiirigelinta	))
Die Kriterien der Stellenausschreibung	((	Shuruudaha Xayeysiinta Shaqada	))
Der Zweck des Anschreibens	((	Ujeedada warqadda daboolka	))
Die Dauer des Bewerbungsprozesses	((	Muddada nidaamka arjiga	))
Die Formalitäten der Bewerbung	((	Milkiilayaasha arjiga	))
Die Vorbereitung auf das Vorstellungsgespräch	((	Diyaarinta wareysiga	))
Die Rückmeldung des Arbeitgebers	((	Jawaab-celinta ka socota loo shaqeeyaha	))
Der Ablauf des Auswahlverfahrens	((	Habka loo soo xusho nidaamka xulashada	))
Die Erfahrung des Bewerbers	((	Khibradda codsadaha	))
Die Qualität der Bewerbungsunterlagen	((	Tayada dukumintiga dalabka	))
Der Eindruck im Bewerbungsgespräch	((	Aragtida wareysiga	))
Die Entscheidung des Personalers	((	Go'aanka shaqaalaha	))
Die Bedeutung der Referenzen	((	Muhiimadda tixraacyada	))
Die Perspektive des Bewerbers	((	Muuqaalka codsadaha	))
Die Schwierigkeiten des Bewerbungsprozesses	((	Dhibaatooyinka nidaamka arjiga	))
Die Aufgaben des neuen Jobs	((	Hawlaha shaqada cusub	))
Die Erwartungen des Arbeitgebers	((	Himilooyinka loo shaqeeyaha	))
Der Beginn der Arbeitsstelle	((	Bilowga shaqada	))
Die Anforderungen des Arbeitsplatzes	((	Shuruudaha goobta shaqada	))
Die Kollegen der Abteilung	((	Asxaabta ee waaxda	))
Die Herausforderungen des Berufs	((	Caqabadaha xirfadda	))
Der Verdienst der Position	((	Mudnaanta booska	))
Die Perspektiven der Karriere	((	Aragtida shaqada	))
Die Regeln des Unternehmens	((	Xeerarka shirkadda	))
Der Alltag am Arbeitsplatz	((	Nolol maalmeedka goobta shaqada	))
Die Verantwortlichkeiten der Rolle	((	Waajibaadka doorka	))
Die Möglichkeiten zur Weiterbildung	((	Fursadaha tababar dheeraad ah	))
Der Beitrag zum Teamerfolg	((	Ku biirinta guusha kooxda	))
Die Schwierigkeiten im Umgang mit Kollegen	((	Dhibaatooyinka wax ka qabashada asxaabta	))
Die Vorteile der Anstellung	((	Faa'iidooyinka shaqada	))
Die Kultur des Arbeitsumfelds	((	Dhaqanka jawiga shaqada	))
Die Entwicklungsmöglichkeiten im Unternehmen	((	Fursadaha horumarinta ee shirkadda	))
Der Konflikt am Arbeitsplatz	((	Khilaafka goobta shaqada	))
Die Balance zwischen Arbeit und Freizeit	((	Dheelitirka u dhexeeya shaqada iyo waqtiga firaaqada	))
Die Beförderungschancen in der Firma	((	Fursadaha dhiirrigelinta shirkadda	))
Die Motivation des Teams	((	Dhiirigelinta kooxda	))
Der Stressfaktor der Aufgabe	((	Qodobka walaaca ee hawsha	))
Die Feedbackkultur im Unternehmen	((	Dhaqanka jawaab-celinta ee shirkadda	))
Der Nutzen der Zusatzleistungen	((	Faa'iidooyinka adeegyada dheeraadka ah	))
Die Erfolge des Projektes	((	Guusha mashruuca	))
Die Auswirkungen der Überstunden	((	Saamaynta saacadaha dheeraadka ah	))
Der Respekt unter den Kollegen	((	Ixtiraamka ka dhexeeya asxaabta	))
Die Flexibilität der Arbeitszeiten	((	Dabacsanaanta saacadaha shaqada	))
Der Beitrag zur Unternehmenskultur	((	Ku biirinta dhaqanka shirkadeed	))
Die Wirkung der Führungskraft	((	Saamaynta maareeyaha	))
Die Qualität der Arbeit	((	Tayada shaqada	))
Die Sicherheit am Arbeitsplatz	((	Amniga goobta shaqada	))
Der Umgang mit der Technologie	((	Wax ka qabashada tikniyoolajiyadda	))
Die Beziehungen innerhalb des Teams	((	Xiriirka ka dhex jira kooxda	))
Die Ziele des Unternehmens	((	Yoolalka shirkadda	))
Der Einfluss der Arbeit auf das Privatleben	((	Saamaynta shaqada ee nolosha gaarka ah	))
Die Fortschritte in der Position	((	Horumarka booska	))
Die Unterstützung durch Vorgesetzte	((	Taageerada ka socota madaxtooyada	))
Der Ablauf des Arbeitstages	((	Inta lagu gudajiro maalinta shaqada	))
Die Herausforderungen der Aufgaben	((	Caqabadaha hawsha	))
Der Druck des Chefs	((	Cadaadiska tababarka	))
Die Beziehung der Kollegen	((	Xiriirka ka dhexeeya asxaabta	))
Der Stress des Projekts	((	Walaaca mashruuca	))
Die Anforderungen der Kunden	((	Shuruudaha macaamiisha	))
Der Umgang mit der Technologie	((	Wax ka qabashada tikniyoolajiyadda	))
Die Lösung der Probleme	((	Xalka dhibaatooyinka	))
Die Wirkung der Pausen	((	Saamaynta biririfta	))
Die Bedeutung der Kommunikation	((	Muhiimadda isgaarsiinta	))
Der Wert der Teamarbeit	((	Qiimaha wada shaqeynta kooxda	))
Die Qualität der Produkte	((	Tayada badeecada	))
Der Beitrag zur Firmenkultur	((	Ku biirinta dhaqanka shirkadda	))
Die Verbesserung der Prozesse	((	Hagaajinta howlaha	))
Die Erwartungen der Vorgesetzten	((	Filashooyinka madax-bannaanida	))
Die Details des Berichts	((	Faahfaahinta warbixinta	))
Die Entwicklung der Fähigkeiten	((	Horumarinta xirfadaha	))
Der Fokus der Besprechungen	((	Diiradda la saaray shirarka	))
Die Motivation der Mitarbeiter	((	Dhiirigelinta shaqaalaha	))
Die Besprechung der Projekte	((	Doodadii mashaariicda	))
Die Anpassung an die Arbeitszeiten	((	Laqabsashada saacadaha shaqada	))
Der Einfluss der Unternehmenspolitik	((	Saamaynta siyaasada shirkaduhu	))
Die Relevanz der Fortbildungen	((	Ku habboonaanta tababarka horumarsan	))
Die Verantwortlichkeit für die Fehler	((	Masuuliyadda khaladaadka	))
Die Vorbereitung der Präsentationen	((	Diyaarinta soojeedinta	))
Die Organisation des Arbeitsbereichs	((	Ururka goobta shaqada	))
Die Steigerung der Produktivität	((	Kordhinta wax soo saarka	))
Die Wahrung der Qualitätsstandards	((	Ilaalinta heerarka tayada	))
Der Respekt vor den Hierarchien	((	Ixtiraamka Hierarchies	))
Die Priorisierung der Aufgaben	((	Muhiimada mudnaanta howlaha	))
Der Umgang mit der Kritik	((	Wax ka qabashada dhaleecaynta	))
Die Integration neuer Mitarbeiter	((	Is dhexgalka shaqaalaha cusub	))
Die Pflege der Firmenwerte	((	Daryeelka shirkadda shirkadda	))
Die Koordination der Teams	((	Isuduwidda kooxaha	))
Die Innovationen in der Branche	((	Hal-abuurka ka jira warshadaha	))
Die Lösung der Kundenprobleme	((	Xalka dhibaatooyinka macaamiisha	))
Der Schutz der Mitarbeiterdaten	((	Ilaalinta xogta shaqaalaha	))
Die Optimierung der Prozesse	((	Kordhinta howlaha	))
Die Analyse der Arbeitsabläufe	((	Falanqaynta howlaha shaqada	))
Die Effizienz der Methoden	((	Hufnaanta hababka	))
Die Planung der Projekte	((	Qorshaynta mashaariicda	))
Die Automatisierung der Aufgaben	((	Otomatiga hawsha	))
Der Rhythmus der Tätigkeiten	((	Laxanka howlaha	))
Die Qualität der Ergebnisse	((	Tayada natiijooyinka	))
Die Kontrolle der Vorgänge	((	Xakameynta hanaanka	))
Der Ablauf der Besprechungen	((	Koorsada shirarka	))
Die Geschwindigkeit der Umsetzung	((	Xawaaraha hirgelinta	))
Die Koordination der Teams	((	Isuduwidda kooxaha	))
Die Flexibilität der Strukturen	((	Dabacsanaanta dhismayaasha	))
Die Verbesserung der Arbeitsabläufe	((	Hagaajinta howlaha shaqada	))
Die Änderung der Strategien	((	Isbedelka xeeladaha	))
Die Präzision der Arbeitsschritte	((	Si sax ah talaabooyinka shaqada	))
Der Fokus der Anstrengungen	((	Diiradda dadaalka	))
Die Praktiken der Problembehebung	((	Ku dhaqanka dhibaatada ee la siinayo	))
Die Interaktion der Abteilungen	((	Is dhexgalka waaxaha	))
Der Zyklus der Produktentwicklung	((	Wareegga horumarka badeecada	))
Die Bewertung der Performance	((	Qiimaynta waxqabadka	))
Die Strukturierung der Informationen	((	Qaab dhismeedka macluumaadka	))
Die Integration der Systeme	((	Is dhexgalka nidaamyada	))
Die Verteilung der Ressourcen	((	Qaybinta Kheyraadka	))
Die Stabilität der Technologie	((	Xasilloonida tikniyoolajiyadda	))
Der Wandel der Organisationsstruktur	((	Isbedelka qaab dhismeedka ururka	))
Die Standardisierung der Prozesse	((	Heerka geedi socodka	))
Die Dokumentation der Veränderungen	((	Dukumentiyada isbedelada	))
Die Anpassung der Richtlinien	((	La-qabsiga Tilmaamaha	))
Die Überprüfung der Qualität	((	Dib u eegista tayada	))
Die Definition der Ziele	((	Qeexitaanka yoolalka	))
Die Anforderungen an die Lieferanten	((	Shuruudaha alaab-qeybiyeyaasha	))
Die Verwaltung der Datenbanken	((	Maamulka keydka macluumaadka	))
Der Austausch von Informationen	((	Isweydaarsiga macluumaadka	))
Die Umsetzung der Neuerungen	((	Hirgelinta hal-abuurka	))
Die Messung der Effektivität	((	Cabbirka waxtarka	))
Die Spezifikation der Aufgaben	((	Faahfaahinta howlaha	))
Die Protokollierung der Meetings	((	Gelitaanka shirarka	))
Die Reduzierung der Kosten	((	Yareynta kharashka	))
Die Kontrolle der Qualität	((	Xakameynta tayada	))
Der Standard des Produkts	((	Heerka sheyga	))
Das Ziel der Qualitätssicherung	((	Hadafka tayada tayada	))
Der Test des Prototyps	((	Tijaabada tusaalaha	))
Die Revision der Dokumente	((	Dib-u-eegista dokumentiyada	))
Die Zertifizierung des Prozesses	((	Shahaadada geedi socodka	))
Das Audit des Systems	((	Hantidhawrka nidaamka	))
Die Anforderung an die Lieferanten	((	Shuruudda dadka alaab-qeybiyeyaasha ah	))
Das Feedback des Kunden	((	Jawaabta macaamiisha	))
Der Bericht der Inspektion	((	Warbixinta kormeerka	))
Die Verbesserung der Methoden	((	Hagaajinta hababka	))
Der Fehler im Produkt	((	Khaladaadka ku jira sheyga	))
Die Messung der Zufriedenheit	((	Cabbirka qanacsanaanta	))
Die Validierung der Daten	((	Ansaxinta xogta	))
Der Prozess des Managements	((	Habka maareynta	))
Das Kriterium für den Erfolg	((	Cabbirka guusha	))
Der Verantwortliche für die Qualität	((	Qofka masuulka ka ah tayada	))
Die Überprüfung der Resultate	((	Dib u eegista natiijooyinka	))
Die Vorgabe für die Produktion	((	Shuruudda wax soo saarka	))
Die Norm für die Sicherheit	((	Heerka amniga	))
Die Einhaltung der Vorschriften	((	U hoggaansanaanta qawaaniinta	))
Die Durchführung des Audits	((	Hirgelinta xisaabtanka	))
Der Ausschluss der Fehlerquelle	((	Ka saarida isha qaladka	))
Die Dokumentation der Vorgänge	((	Dukumentiyada howsha	))
Die Schulung des Personals	((	Tababarka shaqaalaha	))
Die Prüfung der Ausrüstung	((	Tijaabada qalabka	))
Das Monitoring der Prozesse	((	Korjoogteynta howsha	))
Der Zustand der Maschinen	((	Xaaladda Mashiinnada	))
Das Manual für die Benutzung	((	Buugga loo isticmaalo	))
Die Zulassung des Produkts	((	Oggolaanshaha sheyga	))
Das Risiko der Abweichung	((	Khatarta ka leexashada	))
Der Vergleich mit der Konkurrenz	((	Isbarbardhiga tartanka	))
Die Aktualisierung der Methoden	((	Cusboonaysiinta hababka	))
Die Überwachung der Aktivitäten	((	Korjoogteynta howlaha	))
Der Konsens über die Standards	((	Is afgaradka heerarka	))
Die Verlässlichkeit des Lieferanten	((	Ku kalsoonaanta alaab-qeybiyaha	))
Das Profil der Qualität	((	Tayada tayada	))
Die Rückverfolgbarkeit der Komponenten	((	Turnaanta qaybaha	))
Die Bestätigung des Auftrags	((	Xaqiijinta amarka	))
Die Lieferzeit des Produkts	((	Waqtiga gudbinta ee badeecada	))
Der Status der Bestellung	((	Xaaladda amarka	))
Die Rechnung des Verkäufers	((	Qaansheegta iibiyaha	))
Der Versand des Pakets	((	Dhoofinta xirmada	))
Die Verpackung der Ware	((	Baakadaha badeecada	))
Die Kommunikation mit dem Kunden	((	Xiriirka macaamiisha	))
Die Rückmeldung des Systems	((	Jawaab-celinta nidaamka	))
Die Zahlung des Käufers	((	Bixinta iibsadaha	))
Das Angebot des Dienstleisters	((	Bixinta Adeeg Bixiyaha	))
Die Anforderungen des Marktes	((	Shuruudaha suuqa	))
Der Rabatt des Produktes	((	Sicir-dhimista sheyga	))
Die Qualität der Lieferung	((	Tayada dhalmada	))
Die Bewertung des Services	((	Qiimaynta Adeegga	))
Die Stornierung der Bestellung	((	Joojinta amarka	))
Der Kunde des Online-Shops	((	Macaamiisha dukaanka khadka tooska ah	))
Die Lieferung der Artikel	((	Gaarsiinta qodobbada	))
Das Feedback zur Transaktion	((	Jawaab-celinta macaamil ganacsi	))
Die Aktualisierung der Bestandsdaten	((	Cusboonaysiinta xogta alaabada	))
Die Sicherheit der Zahlungsmethoden	((	Amniga qaababka lacag bixinta	))
Die Anweisung zur Benutzung	((	Tilmaanta isticmaalka	))
Der Vertrag des Lieferanten	((	Qandaraaska alaab-qeybiyaha	))
Die Kapazität des Lagers	((	Awoodda bakhaarka	))
Die Vorbereitung der Warensendung	((	Diyaarinta shixnadaha	))
Der Umtausch des Artikels	((	Isweydaarsiga maqaalka	))
Die Bearbeitungszeit der Reklamation	((	Waqtiga hawsha ee cabashada	))
Das Protokoll der Lieferung	((	Borotokoolka gaarsiinta	))
Die Einstellung der Preise	((	Dejinta qiimaha	))
Der Import der Waren	((	Soo dejinta alaabada	))
Die Identifizierung des Problems	((	Aqoonsiga dhibaatada	))
Die Optimierung der Prozesse	((	Kordhinta howlaha	))
Die Skalierung des Geschäfts	((	Qiyaasta ganacsiga	))
Das Management der Ressourcen	((	Maamulka Kheyraadka	))
Die Abwicklung des Exports	((	Ka shaqeynta dhoofinta	))
Die Erneuerung des Sortiments	((	Cusboonaysiinta baaxadda	))
Die Garantie des Herstellers	((	Dammaanadda soo-saaraha	))
Die Zustellung an den Kunden	((	Gaarsiinta macaamiisha	))
Der Zugang zum Kundenkonto	((	Helitaanka akoonka macaamiisha	))
Die Analyse der Beschwerde	((	Falanqaynta cabashada	))
Die Antwort des Kundendienstes	((	Jawaabta ka socota Adeegga Macaamiisha	))
Der Ursprung des Problems	((	Asalka dhibaatada	))
Das Verständnis des Kunden	((	Fahmitaanka macaamiisha	))
Die Bewertung der Situation	((	Qiimaynta xaaladda	))
Der Lösungsvorschlag des Beraters	((	Soo jeedinta lataliyaha	))
Die Zufriedenheit des Kunden	((	Ku qanacsanaanta macaamilka	))
Der Status der Beschwerde	((	Xaaladda cabashada	))
Das Ergebnis der Untersuchung	((	Natiijada baaritaanka	))
Die Dokumentation des Falles	((	Dukumentiyada kiiska	))
Die Kommunikation des Teams	((	Xiriirka kooxda	))
Der Prozess der Nachverfolgung	((	Tijaabinta raadraaca	))
Das Ziel des Beschwerdemanagements	((	Hadafka maareynta cabashada	))
Die Verbesserung des Services	((	Hagaajinta adeegga	))
Die Eskalation des Konflikts	((	Kordhinta khilaafka	))
Die Rückmeldung des Kunden	((	Jawaabta macaamiisha	))
Der Eingang der Beschwerde	((	Helitaanka cabashada	))
Die Bearbeitung des Anliegens	((	Ka baaraandegida welwelka	))
Das Feedback des Kunden	((	Jawaabta macaamiisha	))
Der Verlauf der Kommunikation	((	Koorsada isgaarsiinta	))
Die Reaktion des Unternehmens	((	Falcelinta Shirkadda	))
Der Umgang mit der Kritik	((	Wax ka qabashada dhaleecaynta	))
Die Erwartung des Kunden	((	Filashada macaamiisha	))
Die Konsequenzen des Fehlers	((	Cawaaqibka qaladka	))
Die Schnelligkeit der Lösung	((	Xawaaraha xalka	))
Das Engagement des Mitarbeiters	((	Go'aanka shaqaalaha	))
Die Priorität des Problems	((	Mudnaanta dhibaatada	))
Der Kontext der Beschwerde	((	Macnaha guud ee cabashada	))
Die Befugnis des Managers	((	Maamulka Maamulaha	))
Die Strategie des Beschwerdemanagements	((	Istaraatiijiyadda Maareynta Cabashada	))
Die Verantwortung des Teams	((	Masuuliyadda kooxda	))
Die Meldung des Vorfalls	((	Farriinta dhacdada	))
Das Verfahren zur Konfliktlösung	((	Habka loo qabo xallinta khilaafaadka	))
Die Initiative zur Veränderung	((	Iigalinta isbedelka	))
Die Resonanz auf die Maßnahme	((	Jawaabta cabirka	))
Die Beziehung zum Kunden	((	Xiriirka uu la leeyahay macaamiisha	))
Die Integration der Lösungsansätze	((	Is dhexgalka xalka	))
Die Effizienz der Bearbeitung	((	Hufnaanta hawlgalka	))
Der Fokus des Gesprächs	((	Diiradda sheekada	))
Der Stand des Unternehmens	((	Istaagtii shirkadda	))
Die Präsentation der Produkte	((	Soo bandhigida badeecada	))
Der Besucher des Messestands	((	Soo booqdaha istaaga	))
Die Öffnungszeit der Messe	((	Waqtiga furitaanka ee caddaaladda	))
Die Organisation des Events	((	Ururka dhacdada	))
Die Anzahl der Aussteller	((	Tirada bandhigyada	))
Das Interesse des Publikums	((	Xiisaha dhagaystayaasha	))
Der Erfolg der Veranstaltung	((	Guusha dhacdada	))
Die Planung der Messeaktivitäten	((	Qorshaynta howlaha cadawga ganacsiga	))
Der Flyer des Unternehmens	((	Xaashida shirkadda	))
Die Vorbereitung des Teams	((	Diyaarinta kooxda	))
Die Strategie der Produktplatzierung	((	Istaraatiijiyadda meelaynta badeecada	))
Die Vorstellung des Services	((	Fikradda adeegga	))
Der Verkauf der Artikel	((	Iibinta qodobbada	))
Das Feedback der Besucher	((	Jawaab-celinta booqdayaasha	))
Die Lage des Messestands	((	Goobta muuqaalka bandhigga	))
Das Ziel der Messebeteiligung	((	Ujeeddada ka-qaybgalka Ganacsiga	))
Der Vorteil der Präsentation	((	Faa'iidada soojeedinta	))
Die Informationsbroschüre des Produkts	((	Buug-yaraha macluumaadka ee sheyga	))
Das Logo des Unternehmens	((	Logo shirkadda	))
Die Herausforderung der Selbstständigkeit	((	Caqabadda madax-bannaanida	))
Der Vorteil des eigenen Chefs	((	Faa'iidada tababarkaaga	))
Das Risiko des Unternehmertums	((	Khatarta ganacsi abuuris	))
Die Freiheit des Arbeitsalltags	((	Xorriyadda shaqo maalmeedka	))
Der Erfolg des Geschäftsmodells	((	Guusha Moodeelka Ganacsiga	))
Die Investition des Kapitals	((	Maalgashiga caasimada	))
Das Ziel der Unabhängigkeit	((	Hadafka madax-bannaanida	))
Die Planung der Unternehmensgründung	((	Qorshaynta aasaaska shirkadda	))
Die Verantwortung des Geschäftsführers	((	Masuuliyadda Maareeyaha Maareynta	))
Die Flexibilität der Arbeit	((	Dabacsanaanta shaqada	))
Der Kunde des Dienstleisters	((	Macaamiisha adeeg bixiyaha	))
Die Kontrolle der Finanzen	((	Xakameynta dhaqaalaha	))
Die Strategie des Marketings	((	Istaraatiijiyadda suuq geynta	))
Die Schwierigkeit der Entscheidungsfindung	((	Dhibaatada go'aan qaadashada	))
Der Umsatz des Unternehmens	((	Shirkadda shirkadda	))
Die Vision der Firma	((	Himilada shirkadda	))
Das Netzwerk des Freelancers	((	Shabakada 'Freecraasers'	))
Die Fähigkeit zur Selbstorganisation	((	Awoodda is-abuurista	))
Das Feedback der Klienten	((	Jawaab-celinta ka socota macaamiisha	))
Die Balance der Work-Life-Balance	((	Dheelitirka dheelitirka nolosha shaqada	))
Die Höhe der Abgaben	((	Qaddarka cashuurta	))
Die Qualität der Leistungen	((	Tayada adeegyada	))
Die Fälligkeit der Zahlung	((	Taariikhda bixinta lacag bixinta	))
Die Erstattung der Kosten	((	Dib u soo celinta kharashaadka	))
Das Niveau der Dienstleistung	((	Heerka adeegga	))
Die Anforderungen an die Leistungen	((	Shuruudaha adeegyada	))
Die Überprüfung der Abrechnung	((	Hubinta biilka	))
Der Umfang der Erstattungen	((	Baaxadda magdhawga	))
Das Kriterium für die Leistungsbewertung	((	Cabbirka qiimeynta waxqabadka	))
Die Senkung der Steuern	((	Dhimista canshuuraha	))
Die Erhöhung der Beiträge	((	Kordhinta tabaruca	))
Die Verbesserung der Angebote	((	Hagaajinta deeqaha	))
Die Verteilung der Ressourcen	((	Qaybinta Kheyraadka	))
Die Beurteilung der Ergebnisse	((	Qiimaynta natiijooyinka	))
Der Zugang zu den Leistungen	((	Helitaanka adeegyada	))
Die Reduzierung der Abgaben	((	Dhimista canshuuraha	))
Der Anspruch auf die Dienstleistungen	((	Xuquuqda adeegyada	))
Das Formular für die Anmeldung	((	Foomka diiwaangelinta	))
Die Optimierung der Prozesse	((	Kordhinta howlaha	))
Die Implementierung der Änderungen	((	Hirgelinta isbedelada	))
Die Beratung des Kunden	((	La talinta macaamiisha	))
Der Erhalt der Quittung	((	Rasiidhada risiidka	))
Die Bewertung der Leistung	((	Qiimaynta adeegga	))
Die Skalierung der Gebühren	((	Qiyaasta khidmadaha	))
Der Nutzen der Angebote	((	Faa'iidooyinka deeqaha	))
Die Verwaltung der Mittel	((	Maamulka lacagaha	))
Der Vergleich der Anbieter	((	Isbarbardhiga bixiyeyaasha	))
Die Anpassung der Tarife	((	Hagaajinta xaashiyaha	))
Die Veröffentlichung der Informationen	((	Daabacaadda macluumaadka	))
Die Erfüllung der Pflichten	((	Dhammaystirka waajibaadka	))
Die Erweiterung der Leistungspalette	((	Ballaarinta adeegyada kala duwan ee adeegyada	))
Die Durchführung der Bewertungen	((	Hirgelinta dib u eegista	))
Die Korrektur der Fehler	((	Sixitaanka khaladaadka	))
Die Aktualisierung der Daten	((	Cusboonaysiinta xogta	))
Die Reklamation der Dienstleistungen	((	Cabashada Adeegyada	))
Die Spezifikation der Anforderungen	((	Faahfaahinta shuruudaha	))
Die Transparenz der Zahlungen	((	Daahfurnaanta lacagaha	))
Die Kontrolle der Leistungserbringung	((	Xakameynta bixinta adeegga	))
Die Maximierung der Profite	((	Kordhinta faa'iidooyinka	))
Die Anforderung der Rückerstattung	((	Codsiga magdhowga	))